AAAAATGTAGGACTCGAAG -> AAAATGTAGGACTCGAAGG
AAAATCTACGGGGGTAAAT -> AAATCTACGGGGGTAAATA
AAAATGTAGGACTCGAAGG -> AAATGTAGGACTCGAAGGC
AAAATGTGTAAGCGAGACC -> AAATGTGTAAGCGAGACCT
AAACACCAAGGTAACATCA -> AACACCAAGGTAACATCAC
AAACACCTCCTAGGTCACC -> AACACCTCCTAGGTCACCT
AAACATAACGATGTTACAG -> AACATAACGATGTTACAGC
AAACCAGCAAGCTGGTTGT -> AACCAGCAAGCTGGTTGTC
AAACGGATAGAAGTCGTCG -> AACGGATAGAAGTCGTCGA
AAACTTGCGGAGGCCTATG -> AACTTGCGGAGGCCTATGA
AAAGAGCGCAGGCCGCCAA -> AAGAGCGCAGGCCGCCAAA
AAAGCGCCCCTGTAAGTTT -> AAGCGCCCCTGTAAGTTTG
AAAGCGTAGGATTCCTGGA -> AAGCGTAGGATTCCTGGAC
AAAGCTCATTAGTTGTACA -> AAGCTCATTAGTTGTACAA
AAAGGTGGTTGCAACGTGG -> AAGGTGGTTGCAACGTGGA
AAAGTGGCCTCGAAATACG -> AAGTGGCCTCGAAATACGT
AAATACGTGGCCCATGAGG -> AATACGTGGCCCATGAGGT
AAATAGTGGTAGAAACGGA -> AATAGTGGTAGAAACGGAT
AAATATAGGATAACACCTG -> AATATAGGATAACACCTGA
AAATCCTTGGGTCCGTTCC -> AATCCTTGGGTCCGTTCCA
AAATCGTGATCGGGCATAT -> AATCGTGATCGGGCATATA
AAATCTACGGGGGTAAATA -> AATCTACGGGGGTAAATAG
AAATGTAGGACTCGAAGGC -> AATGTAGGACTCGAAGGCA
AAATGTGTAAGCGAGACCT -> AATGTGTAAGCGAGACCTC
AAATTGACGGAAACACCAA -> AATTGACGGAAACACCAAG
AAATTGCTATCCACTGGGT -> AATTGCTATCCACTGGGTA
AACAAACACCTCCTAGGTC -> ACAAACACCTCCTAGGTCA
AACAAAGAGCGCAGGCCGC -> ACAAAGAGCGCAGGCCGCC
AACACCAAGGTAACATCAC -> ACACCAAGGTAACATCACT
AACACCTCCTAGGTCACCT -> ACACCTCCTAGGTCACCTG
AACACCTGACGCACTGCTA -> ACACCTGACGCACTGCTAT
AACACTATGATTGGGAGAT -> ACACTATGATTGGGAGATC
AACATAACGATGTTACAGC -> ACATAACGATGTTACAGCC
AACATCACTCCGATAGGTG -> ACATCACTCCGATAGGTGA
AACCAGCAAGCTGGTTGTC -> ACCAGCAAGCTGGTTGTCA
AACCAGCTCGACCTAGTTG -> ACCAGCTCGACCTAGTTGG
AACCCGGTGAGGATTGGAA -> ACCCGGTGAGGATTGGAAG
AACCGACAACTAAAGCTCA -> ACCGACAACTAAAGCTCAT
AACCTTCCACGGACGGAGA -> ACCTTCCACGGACGGAGAA
AACCTTGAGTCGCTCGTAA -> ACCTTGAGTCGCTCGTAAG
AACGATGTTACAGCCGCCC -> ACGATGTTACAGCCGCCCT
AACGGATAGAAGTCGTCGA -> ACGGATAGAAGTCGTCGAT
AACGGATGCCATCGGCTCC -> ACGGATGCCATCGGCTCCC
AACGTCACCATCTCGAAAC -> ACGTCACCATCTCGAAACC
AACGTGGATAGACAGCTTG -> ACGTGGATAGACAGCTTGC
AACGTGGCCCTTACATGTA -> ACGTGGCCCTTACATGTAC
AACTAAAGCTCATTAGTTG -> ACTAAAGCTCATTAGTTGT
AACTAGAAACTTGCGGAGG -> ACTAGAAACTTGCGGAGGC
AACTAGGCCCCCGTGCGGT -> ACTAGGCCCCCGTGCGGTT
AACTAGTATGACAGCTCGG -> ACTAGTATGACAGCTCGGT
AACTATCCGGCAGGCACTT -> ACTATCCGGCAGGCACTTC
AACTCATAGGGCAGGAGGT -> ACTCATAGGGCAGGAGGTG
AACTCCGGCTACGACACCT -> ACTCCGGCTACGACACCTC
AACTGAACACGGGGACAGA -> ACTGAACACGGGGACAGAA
AACTGCAAGGAGTGAAGCG -> ACTGCAAGGAGTGAAGCGG
AACTGTCAATCATTTAGTC -> ACTGTCAATCATTTAGTCA
AACTTCAACAAAGAGCGCA -> ACTTCAACAAAGAGCGCAG
AACTTCCGCCTTAGCACAG -> ACTTCCGCCTTAGCACAGA
AACTTGCGGAGGCCTATGA -> ACTTGCGGAGGCCTATGAA
AAGAACAAACACCTCCTAG -> AGAACAAACACCTCCTAGG
AAGACAGGGTGGCTATAGA -> AGACAGGGTGGCTATAGAT
AAGACCCATACGCATGATG -> AGACCCATACGCATGATGC
AAGAGCGCAGGCCGCCAAA -> AGAGCGCAGGCCGCCAAAT
AAGATAAGGTGTTTAGACG -> AGATAAGGTGTTTAGACGT
AAGATCACAGCAAGACCCA -> AGATCACAGCAAGACCCAT
AAGATGACGATATCGTGGC -> AGATGACGATATCGTGGCT
AAGATTCTTGTCCAGTTGT -> AGATTCTTGTCCAGTTGTT
AAGCAGACACGAAAATGTG -> AGCAGACACGAAAATGTGT
AAGCCGAGAGGTAGGTGGC -> AGCCGAGAGGTAGGTGGCT
AAGCGAGACCTCCTCCCGA -> AGCGAGACCTCCTCCCGAA
AAGCGCCCCTGTAAGTTTG -> AGCGCCCCTGTAAGTTTGA
AAGCGGATCATTCACATAC -> AGCGGATCATTCACATACC
AAGCGTACACAATTTGCCA -> AGCGTACACAATTTGCCAC
AAGCGTAGGATTCCTGGAC -> AGCGTAGGATTCCTGGACG
AAGCTCATTAGTTGTACAA -> AGCTCATTAGTTGTACAAC
AAGCTGGTTGTCAACTGTC -> AGCTGGTTGTCAACTGTCA
AAGGAAGATCACAGCAAGA -> AGGAAGATCACAGCAAGAC
AAGGACCTAATTTGGTGGC -> AGGACCTAATTTGGTGGCT
AAGGAGTGAAGCGGATCAT -> AGGAGTGAAGCGGATCATT
AAGGATCGCCTCATAAACA -> AGGATCGCCTCATAAACAT
AAGGATGCGAGTTCAAATT -> AGGATGCGAGTTCAAATTG
AAGGCACTGGCTGCACTTT -> AGGCACTGGCTGCACTTTC
AAGGCCTCCGGTGCAATCC -> AGGCCTCCGGTGCAATCCT
AAGGGGCGTGCTCGCCCCA -> AGGGGCGTGCTCGCCCCAA
AAGGTAAAATCTACGGGGG -> AGGTAAAATCTACGGGGGT
AAGGTAACATCACTCCGAT -> AGGTAACATCACTCCGATA
AAGGTGGTTGCAACGTGGA -> AGGTGGTTGCAACGTGGAT
AAGGTGTTTAGACGTCTGA -> AGGTGTTTAGACGTCTGAT
AAGTACGTTCCGCTACCAC -> AGTACGTTCCGCTACCACA
AAGTAGGACTCGATGCCTA -> AGTAGGACTCGATGCCTAT
AAGTCAGTAAATATAGGAT -> AGTCAGTAAATATAGGATA
AAGTCCACGTCGTGAATCT -> AGTCCACGTCGTGAATCTG
AAGTCGATCGACAGGTTGC -> AGTCGATCGACAGGTTGCT
AAGTCGTCGATTAGGAATA -> AGTCGTCGATTAGGAATAG
AAGTGGAAGACAGGGTGGC -> AGTGGAAGACAGGGTGGCT
AAGTGGCCTCGAAATACGT -> AGTGGCCTCGAAATACGTG
AAGTGGGGAACCTTCCACG -> AGTGGGGAACCTTCCACGG
AAGTTTGAGTGTACGCACA -> AGTTTGAGTGTACGCACAA
AATAAGGGGCGTGCTCGCC -> ATAAGGGGCGTGCTCGCCC
AATACGTGGCCCATGAGGT -> ATACGTGGCCCATGAGGTC
AATACTGCTGTGTGGCTTA -> ATACTGCTGTGTGGCTTAG
AATAGGCTTAGGGCGTGTT -> ATAGGCTTAGGGCGTGTTA
AATAGTGGTAGAAACGGAT -> ATAGTGGTAGAAACGGATA
AATAGTTTGATCGCTTTGC -> ATAGTTTGATCGCTTTGCC
AATATAGGATAACACCTGA -> ATATAGGATAACACCTGAC
AATCATACGGTATGCTCTT -> ATCATACGGTATGCTCTTC
AATCATTTAGTCACCGTGC -> ATCATTTAGTCACCGTGCG
AATCCTTAAATCCTTGGGT -> ATCCTTAAATCCTTGGGTC
AATCCTTGGGTCCGTTCCA -> ATCCTTGGGTCCGTTCCAT
AATCGTGATCGGGCATATA -> ATCGTGATCGGGCATATAT
AATCTACGGGGGTAAATAG -> ATCTACGGGGGTAAATAGT
AATCTGGAACGGATGCCAT -> ATCTGGAACGGATGCCATC
AATGCCCGGTGAGGATTGG -> ATGCCCGGTGAGGATTGGA
AATGGTCGAGCCTGGAGAG -> ATGGTCGAGCCTGGAGAGA
AATGTAGGACTCGAAGGCA -> ATGTAGGACTCGAAGGCAC
AATGTGTAAGCGAGACCTC -> ATGTGTAAGCGAGACCTCC
AATTGACGGAAACACCAAG -> ATTGACGGAAACACCAAGG
AATTGCTATCCACTGGGTA -> ATTGCTATCCACTGGGTAC
AATTTACCGGTTCGTTACA -> ATTTACCGGTTCGTTACAC
AATTTGCCACATCATCGGG -> ATTTGCCACATCATCGGGC
AATTTGGTGGCTATAGATC -> ATTTGGTGGCTATAGATCC
ACAAACACCTCCTAGGTCA -> CAAACACCTCCTAGGTCAC
ACAAAGAGCGCAGGCCGCC -> CAAAGAGCGCAGGCCGCCA
ACAACGTCACCATCTCGAA -> CAACGTCACCATCTCGAAA
ACAACTAAAGCTCATTAGT -> CAACTAAAGCTCATTAGTT
ACAACTAGAAACTTGCGGA -> CAACTAGAAACTTGCGGAG
ACAACTGCAAGGAGTGAAG -> CAACTGCAAGGAGTGAAGC
ACAACTTCAACAAAGAGCG -> CAACTTCAACAAAGAGCGC
ACAAGGATCGCCTCATAAA -> CAAGGATCGCCTCATAAAC
ACAATTTGCCACATCATCG -> CAATTTGCCACATCATCGG
ACACAACGTCACCATCTCG -> CACAACGTCACCATCTCGA
ACACAATTTGCCACATCAT -> CACAATTTGCCACATCATC
ACACATTGGACACTCAAAG -> CACATTGGACACTCAAAGG
ACACCAAGGTAACATCACT -> CACCAAGGTAACATCACTC
ACACCGGGTGTAGAAGTCC -> CACCGGGTGTAGAAGTCCA
ACACCTCCCGTACCTACGC -> CACCTCCCGTACCTACGCG
ACACCTCCTAGGTCACCTG -> CACCTCCTAGGTCACCTGA
ACACCTGACGCACTGCTAT -> CACCTGACGCACTGCTATC
ACACGAAAATGTGTAAGCG -> CACGAAAATGTGTAAGCGA
ACACTATGATTGGGAGATC -> CACTATGATTGGGAGATCG
ACACTCAAAGGTGGTTGCA -> CACTCAAAGGTGGTTGCAA
ACAGACGGAATAGGCTTAG -> CAGACGGAATAGGCTTAGG
ACAGACTGACCACCGTATC -> CAGACTGACCACCGTATCA
ACAGCAACCCGGTGAGGAT -> CAGCAACCCGGTGAGGATT
ACAGCAAGACCCATACGCA -> CAGCAAGACCCATACGCAT
ACAGCCGCCCTTAGACGTG -> CAGCCGCCCTTAGACGTGC
ACAGCTCGGTCCTCGTCTG -> CAGCTCGGTCCTCGTCTGG
ACAGCTTGCTGGCCGGCTA -> CAGCTTGCTGGCCGGCTAG
ACAGCTTTGCGTACTACAC -> CAGCTTTGCGTACTACACC
ACAGGGTGGCTATAGATCC -> CAGGGTGGCTATAGATCCT
ACAGGTTGCTGTCTTCAAT -> CAGGTTGCTGTCTTCAATA
ACATAACGATGTTACAGCC -> CATAACGATGTTACAGCCG
ACATACCTTCAGACGCCAG -> CATACCTTCAGACGCCAGC
ACATCAAGTCGATCGACAG -> CATCAAGTCGATCGACAGG
ACATCACTCCGATAGGTGA -> CATCACTCCGATAGGTGAA
ACATCATCGGGCCATACGC -> CATCATCGGGCCATACGCT
ACATCTCCATCTCCCCTTC -> CATCTCCATCTCCCCTTCA
ACATGACGGCCTAAGGAAG -> CATGACGGCCTAAGGAAGA
ACATGCTACCCGAATGCCC -> CATGCTACCCGAATGCCCG
ACATGTACTCCAACCAGCT -> CATGTACTCCAACCAGCTC
ACATTGGACACTCAAAGGT -> CATTGGACACTCAAAGGTG
ACCAAGGCCTCCGGTGCAA -> CCAAGGCCTCCGGTGCAAT
ACCAAGGTAACATCACTCC -> CCAAGGTAACATCACTCCG
ACCACAAGGATCGCCTCAT -> CCACAAGGATCGCCTCATA
ACCACCGTATCAACTCATA -> CCACCGTATCAACTCATAG
ACCAGCAAGCTGGTTGTCA -> CCAGCAAGCTGGTTGTCAA
ACCAGCTCGACCTAGTTGG -> CCAGCTCGACCTAGTTGGT
ACCATCTCGAAACCAGCAA -> CCATCTCGAAACCAGCAAG
ACCATCTCGCCGCCGGTAC -> CCATCTCGCCGCCGGTACG
ACCATTGTTTCCGTTTTAC -> CCATTGTTTCCGTTTTACG
ACCCATACGCATGATGCGC -> CCCATACGCATGATGCGCA
ACCCATCTTTCAATGGTCG -> CCCATCTTTCAATGGTCGA
ACCCGAATGCCCGGTGAGG -> CCCGAATGCCCGGTGAGGA
ACCCGGTGAGGATTGGAAG -> CCCGGTGAGGATTGGAAGA
ACCCTGCGTGTCCCGGTGA -> CCCTGCGTGTCCCGGTGAG
ACCGACAACTAAAGCTCAT -> CCGACAACTAAAGCTCATT
ACCGCTCCAGACGGCAGCC -> CCGCTCCAGACGGCAGCCC
ACCGGGTGTAGAAGTCCAC -> CCGGGTGTAGAAGTCCACG
ACCGGTTCGTTACACAACG -> CCGGTTCGTTACACAACGT
ACCGTAGCACTGCCTCTAA -> CCGTAGCACTGCCTCTAAC
ACCGTATCAACTCATAGGG -> CCGTATCAACTCATAGGGC
ACCGTGCGTGCGCGATATC -> CCGTGCGTGCGCGATATCA
ACCTAATTTGGTGGCTATA -> CCTAATTTGGTGGCTATAG
ACCTACGCGAAAGCGTAGG -> CCTACGCGAAAGCGTAGGA
ACCTACGCTCCGTCCCGAG -> CCTACGCTCCGTCCCGAGA
ACCTAGTTGGTTGAGCGTC -> CCTAGTTGGTTGAGCGTCC
ACCTCCCGTACCTACGCGA -> CCTCCCGTACCTACGCGAA
ACCTCCTAGGTCACCTGAT -> CCTCCTAGGTCACCTGATC
ACCTCCTCCCGAATTTACC -> CCTCCTCCCGAATTTACCG
ACCTCGACGGCAGATGGCA -> CCTCGACGGCAGATGGCAC
ACCTGACGCACTGCTATCT -> CCTGACGCACTGCTATCTG
ACCTGATCTCCCGACCTAC -> CCTGATCTCCCGACCTACG
ACCTTCAGACGCCAGCTAG -> CCTTCAGACGCCAGCTAGC
ACCTTCCACGGACGGAGAA -> CCTTCCACGGACGGAGAAA
ACCTTGAGTCGCTCGTAAG -> CCTTGAGTCGCTCGTAAGT
ACGAAAATGTGTAAGCGAG -> CGAAAATGTGTAAGCGAGA
ACGAAAGCGCCCCTGTAAG -> CGAAAGCGCCCCTGTAAGT
ACGACACCTCCCGTACCTA -> CGACACCTCCCGTACCTAC
ACGAGGCTACTGCGAAGTA -> CGAGGCTACTGCGAAGTAC
ACGATATCGTGGCTATAGA -> CGATATCGTGGCTATAGAT
ACGATGCCGACTCGCCGCT -> CGATGCCGACTCGCCGCTA
ACGATGTTACAGCCGCCCT -> CGATGTTACAGCCGCCCTT
ACGCAATCATACGGTATGC -> CGCAATCATACGGTATGCT
ACGCACAACTAGAAACTTG -> CGCACAACTAGAAACTTGC
ACGCACTGCTATCTGTGCA -> CGCACTGCTATCTGTGCAG
ACGCATGATGCGCAAATCG -> CGCATGATGCGCAAATCGT
ACGCCAGCTAGCCAAGGTA -> CGCCAGCTAGCCAAGGTAA
ACGCGAAAGCGTAGGATTC -> CGCGAAAGCGTAGGATTCC
ACGCTAGACTGCAACTATC -> CGCTAGACTGCAACTATCC
ACGCTAGAGACCATTGTTT -> CGCTAGAGACCATTGTTTC
ACGCTCCGTCCCGAGAGCG -> CGCTCCGTCCCGAGAGCGT
ACGCTGCACTTAGTAGCCT -> CGCTGCACTTAGTAGCCTT
ACGGAAACACCAAGGTAAC -> CGGAAACACCAAGGTAACA
ACGGAACCTTGAGTCGCTC -> CGGAACCTTGAGTCGCTCG
ACGGAAGAACAAACACCTC -> CGGAAGAACAAACACCTCC
ACGGAATAGGCTTAGGGCG -> CGGAATAGGCTTAGGGCGT
ACGGACATGACGGCCTAAG -> CGGACATGACGGCCTAAGG
ACGGACGGAGAAAGTGGCC -> CGGACGGAGAAAGTGGCCT
ACGGAGAAAGTGGCCTCGA -> CGGAGAAAGTGGCCTCGAA
ACGGATAGAAGTCGTCGAT -> CGGATAGAAGTCGTCGATT
ACGGATGCCATCGGCTCCC -> CGGATGCCATCGGCTCCCA
ACGGCAGATGGCACCAAGG -> CGGCAGATGGCACCAAGGC
ACGGCAGCCCCGGTGAGGA -> CGGCAGCCCCGGTGAGGAT
ACGGCCTAAGGAAGATCAC -> CGGCCTAAGGAAGATCACA
ACGGGGGTAAATAGTGGTA -> CGGGGGTAAATAGTGGTAG
ACGGGGTTCGCATACCGCT -> CGGGGTTCGCATACCGCTC
ACGGTATGCTCTTCAGGCC -> CGGTATGCTCTTCAGGCCA
ACGTCACCATCTCGAAACC -> CGTCACCATCTCGAAACCA
ACGTCGCTGGTATGAAGCG -> CGTCGCTGGTATGAAGCGT
ACGTCGTGAATCTGGAACG -> CGTCGTGAATCTGGAACGG
ACGTCTGATAACACTATGA -> CGTCTGATAACACTATGAT
ACGTCTGTGTTTTGTGAGT -> CGTCTGTGTTTTGTGAGTG
ACGTGCATTAGCTATCCTC -> CGTGCATTAGCTATCCTCA
ACGTGGATAGACAGCTTGC -> CGTGGATAGACAGCTTGCT
ACGTGGCCCATGAGGTCCC -> CGTGGCCCATGAGGTCCCC
ACGTGGCCCTTACATGTAC -> CGTGGCCCTTACATGTACT
ACGTTCCGCTACCACAAGG -> CGTTCCGCTACCACAAGGA
ACTAAAAATGTAGGACTCG -> CTAAAAATGTAGGACTCGA
ACTAAAGCTCATTAGTTGT -> CTAAAGCTCATTAGTTGTA
ACTAACTTCCGCCTTAGCA -> CTAACTTCCGCCTTAGCAC
ACTACACCGGGTGTAGAAG -> CTACACCGGGTGTAGAAGT
ACTAGAAACTTGCGGAGGC -> CTAGAAACTTGCGGAGGCC
ACTAGGCCCCCGTGCGGTT -> CTAGGCCCCCGTGCGGTTT
ACTAGTATGACAGCTCGGT -> CTAGTATGACAGCTCGGTC
ACTATCCGGCAGGCACTTC -> CTATCCGGCAGGCACTTCA
ACTATGATTGGGAGATCGA -> CTATGATTGGGAGATCGAC
ACTCAAAGGTGGTTGCAAC -> CTCAAAGGTGGTTGCAACG
ACTCATAGGGCAGGAGGTG -> CTCATAGGGCAGGAGGTGA
ACTCCAACCAGCTCGACCT -> CTCCAACCAGCTCGACCTA
ACTCCGATAGGTGAAGTGG -> CTCCGATAGGTGAAGTGGG
ACTCCGGCTACGACACCTC -> CTCCGGCTACGACACCTCC
ACTCGAAGGCACTGGCTGC -> CTCGAAGGCACTGGCTGCA
ACTCGATGCCTATGATGGC -> CTCGATGCCTATGATGGCC
ACTCGATGTCGACCCATCT -> CTCGATGTCGACCCATCTT
ACTCGCCGCTACGCTAGAC -> CTCGCCGCTACGCTAGACT
ACTGAACACGGGGACAGAA -> CTGAACACGGGGACAGAAG
ACTGACCACCGTATCAACT -> CTGACCACCGTATCAACTC
ACTGCAACTATCCGGCAGG -> CTGCAACTATCCGGCAGGC
ACTGCAAGGAGTGAAGCGG -> CTGCAAGGAGTGAAGCGGA
ACTGCCTCTAACCGACAAC -> CTGCCTCTAACCGACAACT
ACTGCGAAGTACGTTCCGC -> CTGCGAAGTACGTTCCGCT
ACTGCTATCTGTGCAGTCT -> CTGCTATCTGTGCAGTCTG
ACTGCTGTGTGGCTTAGAG -> CTGCTGTGTGGCTTAGAGT
ACTGGCTGCACTTTCGCAC -> CTGGCTGCACTTTCGCACC
ACTGGGTACATGCTACCCG -> CTGGGTACATGCTACCCGA
ACTGTATACGCTGCACTTA -> CTGTATACGCTGCACTTAG
ACTGTCAATCATTTAGTCA -> CTGTCAATCATTTAGTCAC
ACTTAGTAGCCTTTGCATC -> CTTAGTAGCCTTTGCATCG
ACTTCAACAAAGAGCGCAG -> CTTCAACAAAGAGCGCAGG
ACTTCACACATTGGACACT -> CTTCACACATTGGACACTC
ACTTCCGCCTTAGCACAGA -> CTTCCGCCTTAGCACAGAC
ACTTGAATACTGCTGTGTG -> CTTGAATACTGCTGTGTGG
ACTTGATGGGTGCAAGTAG -> CTTGATGGGTGCAAGTAGG
ACTTGCGGAGGCCTATGAA -> CTTGCGGAGGCCTATGAAC
ACTTTCGCACCCTGCGTGT -> CTTTCGCACCCTGCGTGTC
AGAAACGGATAGAAGTCGT -> GAAACGGATAGAAGTCGTC
AGAAACTTGCGGAGGCCTA -> GAAACTTGCGGAGGCCTAT
AGAAAGTGGCCTCGAAATA -> GAAAGTGGCCTCGAAATAC
AGAACAAACACCTCCTAGG -> GAACAAACACCTCCTAGGT
AGAACTAGGCCCCCGTGCG -> GAACTAGGCCCCCGTGCGG
AGAAGTCCACGTCGTGAAT -> GAAGTCCACGTCGTGAATC
AGAAGTCGTCGATTAGGAA -> GAAGTCGTCGATTAGGAAT
AGACACGAAAATGTGTAAG -> GACACGAAAATGTGTAAGC
AGACAGCTTGCTGGCCGGC -> GACAGCTTGCTGGCCGGCT
AGACAGGGTGGCTATAGAT -> GACAGGGTGGCTATAGATC
AGACATCTCCATCTCCCCT -> GACATCTCCATCTCCCCTT
AGACCATTGTTTCCGTTTT -> GACCATTGTTTCCGTTTTA
AGACCCATACGCATGATGC -> GACCCATACGCATGATGCG
AGACCTCCTCCCGAATTTA -> GACCTCCTCCCGAATTTAC
AGACGCCAGCTAGCCAAGG -> GACGCCAGCTAGCCAAGGT
AGACGGAAGAACAAACACC -> GACGGAAGAACAAACACCT
AGACGGAATAGGCTTAGGG -> GACGGAATAGGCTTAGGGC
AGACGGCAGCCCCGGTGAG -> GACGGCAGCCCCGGTGAGG
AGACGTCTGATAACACTAT -> GACGTCTGATAACACTATG
AGACGTGCATTAGCTATCC -> GACGTGCATTAGCTATCCT
AGACTGACCACCGTATCAA -> GACTGACCACCGTATCAAC
AGACTGCAACTATCCGGCA -> GACTGCAACTATCCGGCAG
AGAGACATCTCCATCTCCC -> GAGACATCTCCATCTCCCC
AGAGACCATTGTTTCCGTT -> GAGACCATTGTTTCCGTTT
AGAGAGTACAGCAACCCGG -> GAGAGTACAGCAACCCGGT
AGAGCGCAGGCCGCCAAAT -> GAGCGCAGGCCGCCAAATT
AGAGCGTAGCGGGTTTACC -> GAGCGTAGCGGGTTTACCA
AGAGGTAGGTGGCTATAGA -> GAGGTAGGTGGCTATAGAT
AGAGTACAGCAACCCGGTG -> GAGTACAGCAACCCGGTGA
AGAGTGAACTCCGGCTACG -> GAGTGAACTCCGGCTACGA
AGAGTTCGGGTCTACATCA -> GAGTTCGGGTCTACATCAA
AGATAAGGTGTTTAGACGT -> GATAAGGTGTTTAGACGTC
AGATCACAGCAAGACCCAT -> GATCACAGCAAGACCCATA
AGATCCTGCACAGACTGAC -> GATCCTGCACAGACTGACC
AGATCCTGCACCTCGACGG -> GATCCTGCACCTCGACGGC
AGATCCTGCACGGGGTTCG -> GATCCTGCACGGGGTTCGC
AGATCCTGCACTGTATACG -> GATCCTGCACTGTATACGC
AGATCGACTTGATGGGTGC -> GATCGACTTGATGGGTGCA
AGATCGTTCCAGGCCATGG -> GATCGTTCCAGGCCATGGA
AGATGACGATATCGTGGCT -> GATGACGATATCGTGGCTA
AGATGGCACCAAGGCCTCC -> GATGGCACCAAGGCCTCCG
AGATTCTTGTCCAGTTGTT -> GATTCTTGTCCAGTTGTTT
AGCAACCCGGTGAGGATTG -> GCAACCCGGTGAGGATTGG
AGCAAGACCCATACGCATG -> GCAAGACCCATACGCATGA
AGCAAGATTCTTGTCCAGT -> GCAAGATTCTTGTCCAGTT
AGCAAGCTGGTTGTCAACT -> GCAAGCTGGTTGTCAACTG
AGCACAGACGGAATAGGCT -> GCACAGACGGAATAGGCTT
AGCACTGCCTCTAACCGAC -> GCACTGCCTCTAACCGACA
AGCAGACACGAAAATGTGT -> GCAGACACGAAAATGTGTA
AGCAGCAAGATTCTTGTCC -> GCAGCAAGATTCTTGTCCA
AGCCAAGGTAAAATCTACG -> GCCAAGGTAAAATCTACGG
AGCCCCGGTGAGGATTGGA -> GCCCCGGTGAGGATTGGAA
AGCCGAGAGGTAGGTGGCT -> GCCGAGAGGTAGGTGGCTA
AGCCGCCCTTAGACGTGCA -> GCCGCCCTTAGACGTGCAT
AGCCTGGAGAGAGTACAGC -> GCCTGGAGAGAGTACAGCA
AGCCTTTGCATCGGATCGT -> GCCTTTGCATCGGATCGTC
AGCGAGACCTCCTCCCGAA -> GCGAGACCTCCTCCCGAAT
AGCGCAGGCCGCCAAATTG -> GCGCAGGCCGCCAAATTGA
AGCGCCCCTGTAAGTTTGA -> GCGCCCCTGTAAGTTTGAG
AGCGGATCATTCACATACC -> GCGGATCATTCACATACCT
AGCGGGTTTACCATCTCGC -> GCGGGTTTACCATCTCGCC
AGCGTACACAATTTGCCAC -> GCGTACACAATTTGCCACA
AGCGTAGCGGGTTTACCAT -> GCGTAGCGGGTTTACCATC
AGCGTAGGATTCCTGGACG -> GCGTAGGATTCCTGGACGA
AGCGTCCTACTTGAATACT -> GCGTCCTACTTGAATACTG
AGCTAGCCAAGGTAAAATC -> GCTAGCCAAGGTAAAATCT
AGCTATCCTCAGAGTTCGG -> GCTATCCTCAGAGTTCGGG
AGCTCATTAGTTGTACAAC -> GCTCATTAGTTGTACAACT
AGCTCGACCTAGTTGGTTG -> GCTCGACCTAGTTGGTTGA
AGCTCGGTCCTCGTCTGGG -> GCTCGGTCCTCGTCTGGGA
AGCTGGTTGTCAACTGTCA -> GCTGGTTGTCAACTGTCAA
AGCTTGCTGGCCGGCTAGT -> GCTTGCTGGCCGGCTAGTA
AGCTTTGCGTACTACACCG -> GCTTTGCGTACTACACCGG
AGGAAGATCACAGCAAGAC -> GGAAGATCACAGCAAGACC
AGGAATAGTTTGATCGCTT -> GGAATAGTTTGATCGCTTT
AGGACCTAATTTGGTGGCT -> GGACCTAATTTGGTGGCTA
AGGACTCGAAGGCACTGGC -> GGACTCGAAGGCACTGGCT
AGGACTCGATGCCTATGAT -> GGACTCGATGCCTATGATG
AGGAGGTGACTAACTTCCG -> GGAGGTGACTAACTTCCGC
AGGAGTGAAGCGGATCATT -> GGAGTGAAGCGGATCATTC
AGGATAACACCTGACGCAC -> GGATAACACCTGACGCACT
AGGATCGCCTCATAAACAT -> GGATCGCCTCATAAACATA
AGGATGCGAGTTCAAATTG -> GGATGCGAGTTCAAATTGC
AGGATTCCTGGACGATGCC -> GGATTCCTGGACGATGCCG
AGGATTGGAAGATGACGAT -> GGATTGGAAGATGACGATA
AGGATTGGAAGCCGAGAGG -> GGATTGGAAGCCGAGAGGT
AGGATTGGAAGGACCTAAT -> GGATTGGAAGGACCTAATT
AGGATTGGAAGTGGAAGAC -> GGATTGGAAGTGGAAGACA
AGGCACTGGCTGCACTTTC -> GGCACTGGCTGCACTTTCG
AGGCACTTCACACATTGGA -> GGCACTTCACACATTGGAC
AGGCCAAGATAAGGTGTTT -> GGCCAAGATAAGGTGTTTA
AGGCCATGGACTCGATGTC -> GGCCATGGACTCGATGTCG
AGGCCCCCGTGCGGTTTCG -> GGCCCCCGTGCGGTTTCGT
AGGCCGCCAAATTGACGGA -> GGCCGCCAAATTGACGGAA
AGGCCTATGAACTAGTATG -> GGCCTATGAACTAGTATGA
AGGCCTCCGGTGCAATCCT -> GGCCTCCGGTGCAATCCTT
AGGCTACTGCGAAGTACGT -> GGCTACTGCGAAGTACGTT
AGGCTTAGGGCGTGTTAAC -> GGCTTAGGGCGTGTTAACG
AGGGAGAACTAGGCCCCCG -> GGGAGAACTAGGCCCCCGT
AGGGCAGGAGGTGACTAAC -> GGGCAGGAGGTGACTAACT
AGGGCGTGTTAACGTGGCC -> GGGCGTGTTAACGTGGCCC
AGGGGCGTGCTCGCCCCAA -> GGGGCGTGCTCGCCCCAAC
AGGGTGGCTATAGATCCTG -> GGGTGGCTATAGATCCTGC
AGGTAAAATCTACGGGGGT -> GGTAAAATCTACGGGGGTA
AGGTAACATCACTCCGATA -> GGTAACATCACTCCGATAG
AGGTAGGTGGCTATAGATC -> GGTAGGTGGCTATAGATCC
AGGTCACCTGATCTCCCGA -> GGTCACCTGATCTCCCGAC
AGGTCCCCTTATATGGGTG -> GGTCCCCTTATATGGGTGA
AGGTGAAGTGGGGAACCTT -> GGTGAAGTGGGGAACCTTC
AGGTGACTAACTTCCGCCT -> GGTGACTAACTTCCGCCTT
AGGTGGCTATAGATCCTGC -> GGTGGCTATAGATCCTGCA
AGGTGGTTGCAACGTGGAT -> GGTGGTTGCAACGTGGATA
AGGTGTTTAGACGTCTGAT -> GGTGTTTAGACGTCTGATA
AGGTTGCTGTCTTCAATAA -> GGTTGCTGTCTTCAATAAG
AGTAAATATAGGATAACAC -> GTAAATATAGGATAACACC
AGTACAGCAACCCGGTGAG -> GTACAGCAACCCGGTGAGG
AGTACGTTCCGCTACCACA -> GTACGTTCCGCTACCACAA
AGTAGCCTTTGCATCGGAT -> GTAGCCTTTGCATCGGATC
AGTAGGACTCGATGCCTAT -> GTAGGACTCGATGCCTATG
AGTAGTGTGCGAGCAGCAA -> GTAGTGTGCGAGCAGCAAG
AGTATGACAGCTCGGTCCT -> GTATGACAGCTCGGTCCTC
AGTCACCGTGCGTGCGCGA -> GTCACCGTGCGTGCGCGAT
AGTCAGTAAATATAGGATA -> GTCAGTAAATATAGGATAA
AGTCCACGTCGTGAATCTG -> GTCCACGTCGTGAATCTGG
AGTCGATCGACAGGTTGCT -> GTCGATCGACAGGTTGCTG
AGTCGCTCGTAAGTCAGTA -> GTCGCTCGTAAGTCAGTAA
AGTCGTCGATTAGGAATAG -> GTCGTCGATTAGGAATAGT
AGTCTGACGGACATGACGG -> GTCTGACGGACATGACGGC
AGTGAACTCCGGCTACGAC -> GTGAACTCCGGCTACGACA
AGTGAAGCGGATCATTCAC -> GTGAAGCGGATCATTCACA
AGTGGAAGACAGGGTGGCT -> GTGGAAGACAGGGTGGCTA
AGTGGCCTCGAAATACGTG -> GTGGCCTCGAAATACGTGG
AGTGGGGAACCTTCCACGG -> GTGGGGAACCTTCCACGGA
AGTGGTAGAAACGGATAGA -> GTGGTAGAAACGGATAGAA
AGTGTACGCACAACTAGAA -> GTGTACGCACAACTAGAAA
AGTGTGCGAGCAGCAAGAT -> GTGTGCGAGCAGCAAGATT
AGTGTTCTGTTGTACGGAA -> GTGTTCTGTTGTACGGAAC
AGTTCAAATTGCTATCCAC -> GTTCAAATTGCTATCCACT
AGTTCGGGTCTACATCAAG -> GTTCGGGTCTACATCAAGT
AGTTGGTTGAGCGTCCTAC -> GTTGGTTGAGCGTCCTACT
AGTTGTACAACTTCAACAA -> GTTGTACAACTTCAACAAA
AGTTGTTTGTGTGCTATGG -> GTTGTTTGTGTGCTATGGA
AGTTTGAGTGTACGCACAA -> GTTTGAGTGTACGCACAAC
AGTTTGATCGCTTTGCCCA -> GTTTGATCGCTTTGCCCAG
ATAAACATAACGATGTTAC -> TAAACATAACGATGTTACA
ATAACACCTGACGCACTGC -> TAACACCTGACGCACTGCT
ATAACACTATGATTGGGAG -> TAACACTATGATTGGGAGA
ATAACGATGTTACAGCCGC -> TAACGATGTTACAGCCGCC
ATAAGGGGCGTGCTCGCCC -> TAAGGGGCGTGCTCGCCCC
ATAAGGTGTTTAGACGTCT -> TAAGGTGTTTAGACGTCTG
ATACCGCTCCAGACGGCAG -> TACCGCTCCAGACGGCAGC
ATACCTTCAGACGCCAGCT -> TACCTTCAGACGCCAGCTA
ATACGCATGATGCGCAAAT -> TACGCATGATGCGCAAATC
ATACGCTAGAGACCATTGT -> TACGCTAGAGACCATTGTT
ATACGCTGCACTTAGTAGC -> TACGCTGCACTTAGTAGCC
ATACGGTATGCTCTTCAGG -> TACGGTATGCTCTTCAGGC
ATACGTGGCCCATGAGGTC -> TACGTGGCCCATGAGGTCC
ATACTGCTGTGTGGCTTAG -> TACTGCTGTGTGGCTTAGA
ATAGAAGTCGTCGATTAGG -> TAGAAGTCGTCGATTAGGA
ATAGACAGCTTGCTGGCCG -> TAGACAGCTTGCTGGCCGG
ATAGATCCTGCACAGACTG -> TAGATCCTGCACAGACTGA
ATAGATCCTGCACCTCGAC -> TAGATCCTGCACCTCGACG
ATAGATCCTGCACGGGGTT -> TAGATCCTGCACGGGGTTC
ATAGATCCTGCACTGTATA -> TAGATCCTGCACTGTATAC
ATAGATCGTTCCAGGCCAT -> TAGATCGTTCCAGGCCATG
ATAGGATAACACCTGACGC -> TAGGATAACACCTGACGCA
ATAGGCTTAGGGCGTGTTA -> TAGGCTTAGGGCGTGTTAA
ATAGGGCAGGAGGTGACTA -> TAGGGCAGGAGGTGACTAA
ATAGGTGAAGTGGGGAACC -> TAGGTGAAGTGGGGAACCT
ATAGTGGTAGAAACGGATA -> TAGTGGTAGAAACGGATAG
ATAGTTTGATCGCTTTGCC -> TAGTTTGATCGCTTTGCCC
ATATAGGATAACACCTGAC -> TATAGGATAACACCTGACG
ATATATGTAAGCAGACACG -> TATATGTAAGCAGACACGA
ATATCATAGATCGTTCCAG -> TATCATAGATCGTTCCAGG
ATATCGTGGCTATAGATCC -> TATCGTGGCTATAGATCCT
ATATGGGTGATCGGACGAG -> TATGGGTGATCGGACGAGG
ATATGTAAGCAGACACGAA -> TATGTAAGCAGACACGAAA
ATCAACTCATAGGGCAGGA -> TCAACTCATAGGGCAGGAG
ATCAAGTCGATCGACAGGT -> TCAAGTCGATCGACAGGTT
ATCACAGCAAGACCCATAC -> TCACAGCAAGACCCATACG
ATCACTCCGATAGGTGAAG -> TCACTCCGATAGGTGAAGT
ATCATACGGTATGCTCTTC -> TCATACGGTATGCTCTTCA
ATCATAGATCGTTCCAGGC -> TCATAGATCGTTCCAGGCC
ATCATCGGGCCATACGCTA -> TCATCGGGCCATACGCTAG
ATCATTCACATACCTTCAG -> TCATTCACATACCTTCAGA
ATCATTTAGTCACCGTGCG -> TCATTTAGTCACCGTGCGT
ATCCACTGGGTACATGCTA -> TCCACTGGGTACATGCTAC
ATCCGGCAGGCACTTCACA -> TCCGGCAGGCACTTCACAC
ATCCTCAGAGTTCGGGTCT -> TCCTCAGAGTTCGGGTCTA
ATCCTGCACAGACTGACCA -> TCCTGCACAGACTGACCAC
ATCCTGCACCTCGACGGCA -> TCCTGCACCTCGACGGCAG
ATCCTGCACGGGGTTCGCA -> TCCTGCACGGGGTTCGCAT
ATCCTGCACTGTATACGCT -> TCCTGCACTGTATACGCTG
ATCCTTAAATCCTTGGGTC -> TCCTTAAATCCTTGGGTCC
ATCCTTGGGTCCGTTCCAT -> TCCTTGGGTCCGTTCCATC
ATCGACAGGTTGCTGTCTT -> TCGACAGGTTGCTGTCTTC
ATCGACTTGATGGGTGCAA -> TCGACTTGATGGGTGCAAG
ATCGCCTCATAAACATAAC -> TCGCCTCATAAACATAACG
ATCGCTTTGCCCAGGGAGA -> TCGCTTTGCCCAGGGAGAA
ATCGGACGAGGCTACTGCG -> TCGGACGAGGCTACTGCGA
ATCGGATCGTCCACCGTAG -> TCGGATCGTCCACCGTAGC
ATCGGCTCCCACGTCGCTG -> TCGGCTCCCACGTCGCTGG
ATCGGGCATATATGTAAGC -> TCGGGCATATATGTAAGCA
ATCGGGCCATACGCTAGAG -> TCGGGCCATACGCTAGAGA
ATCGTCCACCGTAGCACTG -> TCGTCCACCGTAGCACTGC
ATCGTGATCGGGCATATAT -> TCGTGATCGGGCATATATG
ATCGTGGCTATAGATCCTG -> TCGTGGCTATAGATCCTGC
ATCGTTCCAGGCCATGGAC -> TCGTTCCAGGCCATGGACT
ATCTACGGGGGTAAATAGT -> TCTACGGGGGTAAATAGTG
ATCTCCATCTCCCCTTCAT -> TCTCCATCTCCCCTTCATG
ATCTCCCCTTCATGAGACG -> TCTCCCCTTCATGAGACGG
ATCTCCCGACCTACGCTCC -> TCTCCCGACCTACGCTCCG
ATCTCCTGACTAAAAATGT -> TCTCCTGACTAAAAATGTA
ATCTCGAAACCAGCAAGCT -> TCTCGAAACCAGCAAGCTG
ATCTCGCCGCCGGTACGCA -> TCTCGCCGCCGGTACGCAA
ATCTGGAACGGATGCCATC -> TCTGGAACGGATGCCATCG
ATCTGTGCAGTCTGACGGA -> TCTGTGCAGTCTGACGGAC
ATCTTTCAATGGTCGAGCC -> TCTTTCAATGGTCGAGCCT
ATGAACTAGTATGACAGCT -> TGAACTAGTATGACAGCTC
ATGAAGCGTACACAATTTG -> TGAAGCGTACACAATTTGC
ATGACAGCTCGGTCCTCGT -> TGACAGCTCGGTCCTCGTC
ATGACGATATCGTGGCTAT -> TGACGATATCGTGGCTATA
ATGACGGCCTAAGGAAGAT -> TGACGGCCTAAGGAAGATC
ATGAGACGGAAGAACAAAC -> TGAGACGGAAGAACAAACA
ATGAGGTCCCCTTATATGG -> TGAGGTCCCCTTATATGGG
ATGATGCGCAAATCGTGAT -> TGATGCGCAAATCGTGATC
ATGATGGCCCCGACAGCTT -> TGATGGCCCCGACAGCTTT
ATGATTGGGAGATCGACTT -> TGATTGGGAGATCGACTTG
ATGCCATCGGCTCCCACGT -> TGCCATCGGCTCCCACGTC
ATGCCCGGTGAGGATTGGA -> TGCCCGGTGAGGATTGGAA
ATGCCGACTCGCCGCTACG -> TGCCGACTCGCCGCTACGC
ATGCCTATGATGGCCCCGA -> TGCCTATGATGGCCCCGAC
ATGCGAGTTCAAATTGCTA -> TGCGAGTTCAAATTGCTAT
ATGCGCAAATCGTGATCGG -> TGCGCAAATCGTGATCGGG
ATGCTACCCGAATGCCCGG -> TGCTACCCGAATGCCCGGT
ATGCTCTTCAGGCCAAGAT -> TGCTCTTCAGGCCAAGATA
ATGGACGAAAGCGCCCCTG -> TGGACGAAAGCGCCCCTGT
ATGGACTCGATGTCGACCC -> TGGACTCGATGTCGACCCA
ATGGCACCAAGGCCTCCGG -> TGGCACCAAGGCCTCCGGT
ATGGCCCCGACAGCTTTGC -> TGGCCCCGACAGCTTTGCG
ATGGGTGATCGGACGAGGC -> TGGGTGATCGGACGAGGCT
ATGGGTGCAAGTAGGACTC -> TGGGTGCAAGTAGGACTCG
ATGGTCGAGCCTGGAGAGA -> TGGTCGAGCCTGGAGAGAG
ATGTAAGCAGACACGAAAA -> TGTAAGCAGACACGAAAAT
ATGTACTCCAACCAGCTCG -> TGTACTCCAACCAGCTCGA
ATGTAGGACTCGAAGGCAC -> TGTAGGACTCGAAGGCACT
ATGTCGACCCATCTTTCAA -> TGTCGACCCATCTTTCAAT
ATGTGTAAGCGAGACCTCC -> TGTGTAAGCGAGACCTCCT
ATGTTACAGCCGCCCTTAG -> TGTTACAGCCGCCCTTAGA
ATTAGCTATCCTCAGAGTT -> TTAGCTATCCTCAGAGTTC
ATTAGGAATAGTTTGATCG -> TTAGGAATAGTTTGATCGC
ATTAGTTGTACAACTTCAA -> TTAGTTGTACAACTTCAAC
ATTCACATACCTTCAGACG -> TTCACATACCTTCAGACGC
ATTCCTGGACGATGCCGAC -> TTCCTGGACGATGCCGACT
ATTCTTGTCCAGTTGTTTG -> TTCTTGTCCAGTTGTTTGT
ATTGACGGAAACACCAAGG -> TTGACGGAAACACCAAGGT
ATTGCTATCCACTGGGTAC -> TTGCTATCCACTGGGTACA
ATTGGAAGATGACGATATC -> TTGGAAGATGACGATATCG
ATTGGAAGCCGAGAGGTAG -> TTGGAAGCCGAGAGGTAGG
ATTGGAAGGACCTAATTTG -> TTGGAAGGACCTAATTTGG
ATTGGAAGTGGAAGACAGG -> TTGGAAGTGGAAGACAGGG
ATTGGACACTCAAAGGTGG -> TTGGACACTCAAAGGTGGT
ATTGGGAGATCGACTTGAT -> TTGGGAGATCGACTTGATG
ATTGTTTCCGTTTTACGTC -> TTGTTTCCGTTTTACGTCT
ATTTACCGGTTCGTTACAC -> TTTACCGGTTCGTTACACA
ATTTAGTCACCGTGCGTGC -> TTTAGTCACCGTGCGTGCG
ATTTGCCACATCATCGGGC -> TTTGCCACATCATCGGGCC
ATTTGGTGGCTATAGATCC -> TTTGGTGGCTATAGATCCT
CAAACACCTCCTAGGTCAC -> AAACACCTCCTAGGTCACC
CAAAGAGCGCAGGCCGCCA -> AAAGAGCGCAGGCCGCCAA
CAAAGGTGGTTGCAACGTG -> AAAGGTGGTTGCAACGTGG
CAAATCGTGATCGGGCATA -> AAATCGTGATCGGGCATAT
CAAATTGACGGAAACACCA -> AAATTGACGGAAACACCAA
CAAATTGCTATCCACTGGG -> AAATTGCTATCCACTGGGT
CAACAAAGAGCGCAGGCCG -> AACAAAGAGCGCAGGCCGC
CAACCAGCTCGACCTAGTT -> AACCAGCTCGACCTAGTTG
CAACCCGGTGAGGATTGGA -> AACCCGGTGAGGATTGGAA
CAACGTCACCATCTCGAAA -> AACGTCACCATCTCGAAAC
CAACGTGGATAGACAGCTT -> AACGTGGATAGACAGCTTG
CAACTAAAGCTCATTAGTT -> AACTAAAGCTCATTAGTTG
CAACTAGAAACTTGCGGAG -> AACTAGAAACTTGCGGAGG
CAACTATCCGGCAGGCACT -> AACTATCCGGCAGGCACTT
CAACTCATAGGGCAGGAGG -> AACTCATAGGGCAGGAGGT
CAACTGAACACGGGGACAG -> AACTGAACACGGGGACAGA
CAACTGCAAGGAGTGAAGC -> AACTGCAAGGAGTGAAGCG
CAACTGTCAATCATTTAGT -> AACTGTCAATCATTTAGTC
CAACTTCAACAAAGAGCGC -> AACTTCAACAAAGAGCGCA
CAAGACCCATACGCATGAT -> AAGACCCATACGCATGATG
CAAGATAAGGTGTTTAGAC -> AAGATAAGGTGTTTAGACG
CAAGATTCTTGTCCAGTTG -> AAGATTCTTGTCCAGTTGT
CAAGCTGGTTGTCAACTGT -> AAGCTGGTTGTCAACTGTC
CAAGGAGTGAAGCGGATCA -> AAGGAGTGAAGCGGATCAT
CAAGGATCGCCTCATAAAC -> AAGGATCGCCTCATAAACA
CAAGGCCTCCGGTGCAATC -> AAGGCCTCCGGTGCAATCC
CAAGGTAAAATCTACGGGG -> AAGGTAAAATCTACGGGGG
CAAGGTAACATCACTCCGA -> AAGGTAACATCACTCCGAT
CAAGTAGGACTCGATGCCT -> AAGTAGGACTCGATGCCTA
CAAGTCGATCGACAGGTTG -> AAGTCGATCGACAGGTTGC
CAATAAGGGGCGTGCTCGC -> AATAAGGGGCGTGCTCGCC
CAATCATACGGTATGCTCT -> AATCATACGGTATGCTCTT
CAATCATTTAGTCACCGTG -> AATCATTTAGTCACCGTGC
CAATCCTTAAATCCTTGGG -> AATCCTTAAATCCTTGGGT
CAATGGTCGAGCCTGGAGA -> AATGGTCGAGCCTGGAGAG
CAATTTGCCACATCATCGG -> AATTTGCCACATCATCGGG
CACAACGTCACCATCTCGA -> ACAACGTCACCATCTCGAA
CACAACTAGAAACTTGCGG -> ACAACTAGAAACTTGCGGA
CACAACTGCAAGGAGTGAA -> ACAACTGCAAGGAGTGAAG
CACAAGGATCGCCTCATAA -> ACAAGGATCGCCTCATAAA
CACAATTTGCCACATCATC -> ACAATTTGCCACATCATCG
CACACATTGGACACTCAAA -> ACACATTGGACACTCAAAG
CACAGACGGAATAGGCTTA -> ACAGACGGAATAGGCTTAG
CACAGACTGACCACCGTAT -> ACAGACTGACCACCGTATC
CACAGCAAGACCCATACGC -> ACAGCAAGACCCATACGCA
CACATACCTTCAGACGCCA -> ACATACCTTCAGACGCCAG
CACATCATCGGGCCATACG -> ACATCATCGGGCCATACGC
CACATTGGACACTCAAAGG -> ACATTGGACACTCAAAGGT
CACCAAGGCCTCCGGTGCA -> ACCAAGGCCTCCGGTGCAA
CACCAAGGTAACATCACTC -> ACCAAGGTAACATCACTCC
CACCATCTCGAAACCAGCA -> ACCATCTCGAAACCAGCAA
CACCCTGCGTGTCCCGGTG -> ACCCTGCGTGTCCCGGTGA
CACCGGGTGTAGAAGTCCA -> ACCGGGTGTAGAAGTCCAC
CACCGTAGCACTGCCTCTA -> ACCGTAGCACTGCCTCTAA
CACCGTATCAACTCATAGG -> ACCGTATCAACTCATAGGG
CACCGTGCGTGCGCGATAT -> ACCGTGCGTGCGCGATATC
CACCTCCCGTACCTACGCG -> ACCTCCCGTACCTACGCGA
CACCTCCTAGGTCACCTGA -> ACCTCCTAGGTCACCTGAT
CACCTCGACGGCAGATGGC -> ACCTCGACGGCAGATGGCA
CACCTGACGCACTGCTATC -> ACCTGACGCACTGCTATCT
CACCTGATCTCCCGACCTA -> ACCTGATCTCCCGACCTAC
CACGAAAATGTGTAAGCGA -> ACGAAAATGTGTAAGCGAG
CACGGACGGAGAAAGTGGC -> ACGGACGGAGAAAGTGGCC
CACGGGGTTCGCATACCGC -> ACGGGGTTCGCATACCGCT
CACGTCGCTGGTATGAAGC -> ACGTCGCTGGTATGAAGCG
CACGTCGTGAATCTGGAAC -> ACGTCGTGAATCTGGAACG
CACTATGATTGGGAGATCG -> ACTATGATTGGGAGATCGA
CACTCAAAGGTGGTTGCAA -> ACTCAAAGGTGGTTGCAAC
CACTCCGATAGGTGAAGTG -> ACTCCGATAGGTGAAGTGG
CACTGCCTCTAACCGACAA -> ACTGCCTCTAACCGACAAC
CACTGCTATCTGTGCAGTC -> ACTGCTATCTGTGCAGTCT
CACTGGCTGCACTTTCGCA -> ACTGGCTGCACTTTCGCAC
CACTGGGTACATGCTACCC -> ACTGGGTACATGCTACCCG
CACTGTATACGCTGCACTT -> ACTGTATACGCTGCACTTA
CACTTAGTAGCCTTTGCAT -> ACTTAGTAGCCTTTGCATC
CACTTCACACATTGGACAC -> ACTTCACACATTGGACACT
CACTTTCGCACCCTGCGTG -> ACTTTCGCACCCTGCGTGT
CAGACACGAAAATGTGTAA -> AGACACGAAAATGTGTAAG
CAGACGCCAGCTAGCCAAG -> AGACGCCAGCTAGCCAAGG
CAGACGGAATAGGCTTAGG -> AGACGGAATAGGCTTAGGG
CAGACGGCAGCCCCGGTGA -> AGACGGCAGCCCCGGTGAG
CAGACTGACCACCGTATCA -> AGACTGACCACCGTATCAA
CAGAGTTCGGGTCTACATC -> AGAGTTCGGGTCTACATCA
CAGATGGCACCAAGGCCTC -> AGATGGCACCAAGGCCTCC
CAGCAACCCGGTGAGGATT -> AGCAACCCGGTGAGGATTG
CAGCAAGACCCATACGCAT -> AGCAAGACCCATACGCATG
CAGCAAGATTCTTGTCCAG -> AGCAAGATTCTTGTCCAGT
CAGCAAGCTGGTTGTCAAC -> AGCAAGCTGGTTGTCAACT
CAGCCCCGGTGAGGATTGG -> AGCCCCGGTGAGGATTGGA
CAGCCGCCCTTAGACGTGC -> AGCCGCCCTTAGACGTGCA
CAGCTAGCCAAGGTAAAAT -> AGCTAGCCAAGGTAAAATC
CAGCTCGACCTAGTTGGTT -> AGCTCGACCTAGTTGGTTG
CAGCTCGGTCCTCGTCTGG -> AGCTCGGTCCTCGTCTGGG
CAGCTTGCTGGCCGGCTAG -> AGCTTGCTGGCCGGCTAGT
CAGCTTTGCGTACTACACC -> AGCTTTGCGTACTACACCG
CAGGAGGTGACTAACTTCC -> AGGAGGTGACTAACTTCCG
CAGGCACTTCACACATTGG -> AGGCACTTCACACATTGGA
CAGGCCAAGATAAGGTGTT -> AGGCCAAGATAAGGTGTTT
CAGGCCATGGACTCGATGT -> AGGCCATGGACTCGATGTC
CAGGCCGCCAAATTGACGG -> AGGCCGCCAAATTGACGGA
CAGGGAGAACTAGGCCCCC -> AGGGAGAACTAGGCCCCCG
CAGGGTGGCTATAGATCCT -> AGGGTGGCTATAGATCCTG
CAGGTTGCTGTCTTCAATA -> AGGTTGCTGTCTTCAATAA
CAGTAAATATAGGATAACA -> AGTAAATATAGGATAACAC
CAGTCTGACGGACATGACG -> AGTCTGACGGACATGACGG
CAGTTGTTTGTGTGCTATG -> AGTTGTTTGTGTGCTATGG
CATAAACATAACGATGTTA -> ATAAACATAACGATGTTAC
CATAACGATGTTACAGCCG -> ATAACGATGTTACAGCCGC
CATACCGCTCCAGACGGCA -> ATACCGCTCCAGACGGCAG
CATACCTTCAGACGCCAGC -> ATACCTTCAGACGCCAGCT
CATACGCATGATGCGCAAA -> ATACGCATGATGCGCAAAT
CATACGCTAGAGACCATTG -> ATACGCTAGAGACCATTGT
CATACGGTATGCTCTTCAG -> ATACGGTATGCTCTTCAGG
CATAGATCGTTCCAGGCCA -> ATAGATCGTTCCAGGCCAT
CATAGGGCAGGAGGTGACT -> ATAGGGCAGGAGGTGACTA
CATATATGTAAGCAGACAC -> ATATATGTAAGCAGACACG
CATCAAGTCGATCGACAGG -> ATCAAGTCGATCGACAGGT
CATCACTCCGATAGGTGAA -> ATCACTCCGATAGGTGAAG
CATCATCGGGCCATACGCT -> ATCATCGGGCCATACGCTA
CATCGGATCGTCCACCGTA -> ATCGGATCGTCCACCGTAG
CATCGGCTCCCACGTCGCT -> ATCGGCTCCCACGTCGCTG
CATCGGGCCATACGCTAGA -> ATCGGGCCATACGCTAGAG
CATCTCCATCTCCCCTTCA -> ATCTCCATCTCCCCTTCAT
CATCTCCCCTTCATGAGAC -> ATCTCCCCTTCATGAGACG
CATCTCCTGACTAAAAATG -> ATCTCCTGACTAAAAATGT
CATCTCGAAACCAGCAAGC -> ATCTCGAAACCAGCAAGCT
CATCTCGCCGCCGGTACGC -> ATCTCGCCGCCGGTACGCA
CATCTTTCAATGGTCGAGC -> ATCTTTCAATGGTCGAGCC
CATGACGGCCTAAGGAAGA -> ATGACGGCCTAAGGAAGAT
CATGAGACGGAAGAACAAA -> ATGAGACGGAAGAACAAAC
CATGAGGTCCCCTTATATG -> ATGAGGTCCCCTTATATGG
CATGATGCGCAAATCGTGA -> ATGATGCGCAAATCGTGAT
CATGCTACCCGAATGCCCG -> ATGCTACCCGAATGCCCGG
CATGGACTCGATGTCGACC -> ATGGACTCGATGTCGACCC
CATGTACTCCAACCAGCTC -> ATGTACTCCAACCAGCTCG
CATTAGCTATCCTCAGAGT -> ATTAGCTATCCTCAGAGTT
CATTAGTTGTACAACTTCA -> ATTAGTTGTACAACTTCAA
CATTCACATACCTTCAGAC -> ATTCACATACCTTCAGACG
CATTGGACACTCAAAGGTG -> ATTGGACACTCAAAGGTGG
CATTGTTTCCGTTTTACGT -> ATTGTTTCCGTTTTACGTC
CATTTAGTCACCGTGCGTG -> ATTTAGTCACCGTGCGTGC
CCAAATTGACGGAAACACC -> CAAATTGACGGAAACACCA
CCAACCAGCTCGACCTAGT -> CAACCAGCTCGACCTAGTT
CCAACTGAACACGGGGACA -> CAACTGAACACGGGGACAG
CCAAGATAAGGTGTTTAGA -> CAAGATAAGGTGTTTAGAC
CCAAGGCCTCCGGTGCAAT -> CAAGGCCTCCGGTGCAATC
CCAAGGTAAAATCTACGGG -> CAAGGTAAAATCTACGGGG
CCAAGGTAACATCACTCCG -> CAAGGTAACATCACTCCGA
CCACAAGGATCGCCTCATA -> CACAAGGATCGCCTCATAA
CCACATCATCGGGCCATAC -> CACATCATCGGGCCATACG
CCACCGTAGCACTGCCTCT -> CACCGTAGCACTGCCTCTA
CCACCGTATCAACTCATAG -> CACCGTATCAACTCATAGG
CCACGGACGGAGAAAGTGG -> CACGGACGGAGAAAGTGGC
CCACGTCGCTGGTATGAAG -> CACGTCGCTGGTATGAAGC
CCACGTCGTGAATCTGGAA -> CACGTCGTGAATCTGGAAC
CCACTGGGTACATGCTACC -> CACTGGGTACATGCTACCC
CCAGACGGCAGCCCCGGTG -> CAGACGGCAGCCCCGGTGA
CCAGCAAGCTGGTTGTCAA -> CAGCAAGCTGGTTGTCAAC
CCAGCTAGCCAAGGTAAAA -> CAGCTAGCCAAGGTAAAAT
CCAGCTCGACCTAGTTGGT -> CAGCTCGACCTAGTTGGTT
CCAGGCCATGGACTCGATG -> CAGGCCATGGACTCGATGT
CCAGGGAGAACTAGGCCCC -> CAGGGAGAACTAGGCCCCC
CCAGTTGTTTGTGTGCTAT -> CAGTTGTTTGTGTGCTATG
CCATACGCATGATGCGCAA -> CATACGCATGATGCGCAAA
CCATACGCTAGAGACCATT -> CATACGCTAGAGACCATTG
CCATCGGCTCCCACGTCGC -> CATCGGCTCCCACGTCGCT
CCATCTCCCCTTCATGAGA -> CATCTCCCCTTCATGAGAC
CCATCTCCTGACTAAAAAT -> CATCTCCTGACTAAAAATG
CCATCTCGAAACCAGCAAG -> CATCTCGAAACCAGCAAGC
CCATCTCGCCGCCGGTACG -> CATCTCGCCGCCGGTACGC
CCATCTTTCAATGGTCGAG -> CATCTTTCAATGGTCGAGC
CCATGAGGTCCCCTTATAT -> CATGAGGTCCCCTTATATG
CCATGGACTCGATGTCGAC -> CATGGACTCGATGTCGACC
CCATTGTTTCCGTTTTACG -> CATTGTTTCCGTTTTACGT
CCCAACTGAACACGGGGAC -> CCAACTGAACACGGGGACA
CCCACGTCGCTGGTATGAA -> CCACGTCGCTGGTATGAAG
CCCAGGGAGAACTAGGCCC -> CCAGGGAGAACTAGGCCCC
CCCATACGCATGATGCGCA -> CCATACGCATGATGCGCAA
CCCATCTTTCAATGGTCGA -> CCATCTTTCAATGGTCGAG
CCCATGAGGTCCCCTTATA -> CCATGAGGTCCCCTTATAT
CCCCAACTGAACACGGGGA -> CCCAACTGAACACGGGGAC
CCCCCGTGCGGTTTCGTGG -> CCCCGTGCGGTTTCGTGGT
CCCCGACAGCTTTGCGTAC -> CCCGACAGCTTTGCGTACT
CCCCGGTGAGGATTGGAAG -> CCCGGTGAGGATTGGAAGC
CCCCGTGCGGTTTCGTGGT -> CCCGTGCGGTTTCGTGGTC
CCCCTGTAAGTTTGAGTGT -> CCCTGTAAGTTTGAGTGTA
CCCCTTATATGGGTGATCG -> CCCTTATATGGGTGATCGG
CCCCTTCATGAGACGGAAG -> CCCTTCATGAGACGGAAGA
CCCGAATGCCCGGTGAGGA -> CCGAATGCCCGGTGAGGAT
CCCGAATTTACCGGTTCGT -> CCGAATTTACCGGTTCGTT
CCCGACAGCTTTGCGTACT -> CCGACAGCTTTGCGTACTA
CCCGACCTACGCTCCGTCC -> CCGACCTACGCTCCGTCCC
CCCGAGAGCGTAGCGGGTT -> CCGAGAGCGTAGCGGGTTT
CCCGGTGAGGATTGGAAGA -> CCGGTGAGGATTGGAAGAT
CCCGGTGAGGATTGGAAGC -> CCGGTGAGGATTGGAAGCC
CCCGGTGAGGATTGGAAGG -> CCGGTGAGGATTGGAAGGA
CCCGGTGAGGATTGGAAGT -> CCGGTGAGGATTGGAAGTG
CCCGTACCTACGCGAAAGC -> CCGTACCTACGCGAAAGCG
CCCGTGCGGTTTCGTGGTC -> CCGTGCGGTTTCGTGGTCC
CCCTGCGTGTCCCGGTGAG -> CCTGCGTGTCCCGGTGAGG
CCCTGTAAGTTTGAGTGTA -> CCTGTAAGTTTGAGTGTAC
CCCTTACATGTACTCCAAC -> CCTTACATGTACTCCAACC
CCCTTAGACGTGCATTAGC -> CCTTAGACGTGCATTAGCT
CCCTTATATGGGTGATCGG -> CCTTATATGGGTGATCGGA
CCCTTCATGAGACGGAAGA -> CCTTCATGAGACGGAAGAA
CCGAATGCCCGGTGAGGAT -> CGAATGCCCGGTGAGGATT
CCGAATTTACCGGTTCGTT -> CGAATTTACCGGTTCGTTA
CCGACAACTAAAGCTCATT -> CGACAACTAAAGCTCATTA
CCGACAGCTTTGCGTACTA -> CGACAGCTTTGCGTACTAC
CCGACCTACGCTCCGTCCC -> CGACCTACGCTCCGTCCCG
CCGACTCGCCGCTACGCTA -> CGACTCGCCGCTACGCTAG
CCGAGAGCGTAGCGGGTTT -> CGAGAGCGTAGCGGGTTTA
CCGAGAGGTAGGTGGCTAT -> CGAGAGGTAGGTGGCTATA
CCGATAGGTGAAGTGGGGA -> CGATAGGTGAAGTGGGGAA
CCGCCAAATTGACGGAAAC -> CGCCAAATTGACGGAAACA
CCGCCCTTAGACGTGCATT -> CGCCCTTAGACGTGCATTA
CCGCCGGTACGCAATCATA -> CGCCGGTACGCAATCATAC
CCGCCTTAGCACAGACGGA -> CGCCTTAGCACAGACGGAA
CCGCTACCACAAGGATCGC -> CGCTACCACAAGGATCGCC
CCGCTACGCTAGACTGCAA -> CGCTACGCTAGACTGCAAC
CCGCTCCAGACGGCAGCCC -> CGCTCCAGACGGCAGCCCC
CCGGCAGGCACTTCACACA -> CGGCAGGCACTTCACACAT
CCGGCGAGAGACATCTCCA -> CGGCGAGAGACATCTCCAT
CCGGCTACGACACCTCCCG -> CGGCTACGACACCTCCCGT
CCGGCTAGTAGTGTGCGAG -> CGGCTAGTAGTGTGCGAGC
CCGGGTGTAGAAGTCCACG -> CGGGTGTAGAAGTCCACGT
CCGGTACGCAATCATACGG -> CGGTACGCAATCATACGGT
CCGGTGAGGATTGGAAGAT -> CGGTGAGGATTGGAAGATG
CCGGTGAGGATTGGAAGCC -> CGGTGAGGATTGGAAGCCG
CCGGTGAGGATTGGAAGGA -> CGGTGAGGATTGGAAGGAC
CCGGTGAGGATTGGAAGTG -> CGGTGAGGATTGGAAGTGG
CCGGTGCAATCCTTAAATC -> CGGTGCAATCCTTAAATCC
CCGGTTCGTTACACAACGT -> CGGTTCGTTACACAACGTC
CCGTACCTACGCGAAAGCG -> CGTACCTACGCGAAAGCGT
CCGTAGCACTGCCTCTAAC -> CGTAGCACTGCCTCTAACC
CCGTATCAACTCATAGGGC -> CGTATCAACTCATAGGGCA
CCGTCCCGAGAGCGTAGCG -> CGTCCCGAGAGCGTAGCGG
CCGTGCGGTTTCGTGGTCC -> CGTGCGGTTTCGTGGTCCG
CCGTGCGTGCGCGATATCA -> CGTGCGTGCGCGATATCAT
CCGTTCCATCTCCTGACTA -> CGTTCCATCTCCTGACTAA
CCGTTTTACGTCTGTGTTT -> CGTTTTACGTCTGTGTTTT
CCTAAGGAAGATCACAGCA -> CTAAGGAAGATCACAGCAA
CCTAATTTGGTGGCTATAG -> CTAATTTGGTGGCTATAGA
CCTACGCGAAAGCGTAGGA -> CTACGCGAAAGCGTAGGAT
CCTACGCTCCGTCCCGAGA -> CTACGCTCCGTCCCGAGAG
CCTACTTGAATACTGCTGT -> CTACTTGAATACTGCTGTG
CCTAGGTCACCTGATCTCC -> CTAGGTCACCTGATCTCCC
CCTAGTTGGTTGAGCGTCC -> CTAGTTGGTTGAGCGTCCT
CCTATGAACTAGTATGACA -> CTATGAACTAGTATGACAG
CCTATGATGGCCCCGACAG -> CTATGATGGCCCCGACAGC
CCTCAGAGTTCGGGTCTAC -> CTCAGAGTTCGGGTCTACA
CCTCATAAACATAACGATG -> CTCATAAACATAACGATGT
CCTCCCGAATTTACCGGTT -> CTCCCGAATTTACCGGTTC
CCTCCCGTACCTACGCGAA -> CTCCCGTACCTACGCGAAA
CCTCCGGTGCAATCCTTAA -> CTCCGGTGCAATCCTTAAA
CCTCCTAGGTCACCTGATC -> CTCCTAGGTCACCTGATCT
CCTCCTCCCGAATTTACCG -> CTCCTCCCGAATTTACCGG
CCTCGAAATACGTGGCCCA -> CTCGAAATACGTGGCCCAT
CCTCGACGGCAGATGGCAC -> CTCGACGGCAGATGGCACC
CCTCGTCTGGGAAGGATGC -> CTCGTCTGGGAAGGATGCG
CCTCTAACCGACAACTAAA -> CTCTAACCGACAACTAAAG
CCTGACGCACTGCTATCTG -> CTGACGCACTGCTATCTGT
CCTGACTAAAAATGTAGGA -> CTGACTAAAAATGTAGGAC
CCTGATCTCCCGACCTACG -> CTGATCTCCCGACCTACGC
CCTGCACAGACTGACCACC -> CTGCACAGACTGACCACCG
CCTGCACCTCGACGGCAGA -> CTGCACCTCGACGGCAGAT
CCTGCACGGGGTTCGCATA -> CTGCACGGGGTTCGCATAC
CCTGCACTGTATACGCTGC -> CTGCACTGTATACGCTGCA
CCTGCGTGTCCCGGTGAGG -> CTGCGTGTCCCGGTGAGGA
CCTGGACGATGCCGACTCG -> CTGGACGATGCCGACTCGC
CCTGGAGAGAGTACAGCAA -> CTGGAGAGAGTACAGCAAC
CCTGTAAGTTTGAGTGTAC -> CTGTAAGTTTGAGTGTACG
CCTTAAATCCTTGGGTCCG -> CTTAAATCCTTGGGTCCGT
CCTTACATGTACTCCAACC -> CTTACATGTACTCCAACCA
CCTTAGACGTGCATTAGCT -> CTTAGACGTGCATTAGCTA
CCTTAGCACAGACGGAATA -> CTTAGCACAGACGGAATAG
CCTTATATGGGTGATCGGA -> CTTATATGGGTGATCGGAC
CCTTCAGACGCCAGCTAGC -> CTTCAGACGCCAGCTAGCC
CCTTCATGAGACGGAAGAA -> CTTCATGAGACGGAAGAAC
CCTTCCACGGACGGAGAAA -> CTTCCACGGACGGAGAAAG
CCTTGAGTCGCTCGTAAGT -> CTTGAGTCGCTCGTAAGTC
CCTTGGGTCCGTTCCATCT -> CTTGGGTCCGTTCCATCTC
CCTTTGCATCGGATCGTCC -> CTTTGCATCGGATCGTCCA
CGAAAATGTGTAAGCGAGA -> GAAAATGTGTAAGCGAGAC
CGAAACCAGCAAGCTGGTT -> GAAACCAGCAAGCTGGTTG
CGAAAGCGCCCCTGTAAGT -> GAAAGCGCCCCTGTAAGTT
CGAAAGCGTAGGATTCCTG -> GAAAGCGTAGGATTCCTGG
CGAAATACGTGGCCCATGA -> GAAATACGTGGCCCATGAG
CGAAGGCACTGGCTGCACT -> GAAGGCACTGGCTGCACTT
CGAAGTACGTTCCGCTACC -> GAAGTACGTTCCGCTACCA
CGAATGCCCGGTGAGGATT -> GAATGCCCGGTGAGGATTG
CGAATTTACCGGTTCGTTA -> GAATTTACCGGTTCGTTAC
CGACAACTAAAGCTCATTA -> GACAACTAAAGCTCATTAG
CGACACCTCCCGTACCTAC -> GACACCTCCCGTACCTACG
CGACAGCTTTGCGTACTAC -> GACAGCTTTGCGTACTACA
CGACAGGTTGCTGTCTTCA -> GACAGGTTGCTGTCTTCAA
CGACCCATCTTTCAATGGT -> GACCCATCTTTCAATGGTC
CGACCTACGCTCCGTCCCG -> GACCTACGCTCCGTCCCGA
CGACCTAGTTGGTTGAGCG -> GACCTAGTTGGTTGAGCGT
CGACGGCAGATGGCACCAA -> GACGGCAGATGGCACCAAG
CGACTCGCCGCTACGCTAG -> GACTCGCCGCTACGCTAGA
CGACTTGATGGGTGCAAGT -> GACTTGATGGGTGCAAGTA
CGAGACCTCCTCCCGAATT -> GAGACCTCCTCCCGAATTT
CGAGAGACATCTCCATCTC -> GAGAGACATCTCCATCTCC
CGAGAGCGTAGCGGGTTTA -> GAGAGCGTAGCGGGTTTAC
CGAGAGGTAGGTGGCTATA -> GAGAGGTAGGTGGCTATAG
CGAGCAGCAAGATTCTTGT -> GAGCAGCAAGATTCTTGTC
CGAGCCTGGAGAGAGTACA -> GAGCCTGGAGAGAGTACAG
CGAGGCTACTGCGAAGTAC -> GAGGCTACTGCGAAGTACG
CGAGTTCAAATTGCTATCC -> GAGTTCAAATTGCTATCCA
CGATAGGTGAAGTGGGGAA -> GATAGGTGAAGTGGGGAAC
CGATATCATAGATCGTTCC -> GATATCATAGATCGTTCCA
CGATATCGTGGCTATAGAT -> GATATCGTGGCTATAGATC
CGATCGACAGGTTGCTGTC -> GATCGACAGGTTGCTGTCT
CGATGCCGACTCGCCGCTA -> GATGCCGACTCGCCGCTAC
CGATGCCTATGATGGCCCC -> GATGCCTATGATGGCCCCG
CGATGTCGACCCATCTTTC -> GATGTCGACCCATCTTTCA
CGATGTTACAGCCGCCCTT -> GATGTTACAGCCGCCCTTA
CGATTAGGAATAGTTTGAT -> GATTAGGAATAGTTTGATC
CGCAAATCGTGATCGGGCA -> GCAAATCGTGATCGGGCAT
CGCAATCATACGGTATGCT -> GCAATCATACGGTATGCTC
CGCACAACTAGAAACTTGC -> GCACAACTAGAAACTTGCG
CGCACCCTGCGTGTCCCGG -> GCACCCTGCGTGTCCCGGT
CGCACTGCTATCTGTGCAG -> GCACTGCTATCTGTGCAGT
CGCAGGCCGCCAAATTGAC -> GCAGGCCGCCAAATTGACG
CGCATACCGCTCCAGACGG -> GCATACCGCTCCAGACGGC
CGCATGATGCGCAAATCGT -> GCATGATGCGCAAATCGTG
CGCCAAATTGACGGAAACA -> GCCAAATTGACGGAAACAC
CGCCAGCTAGCCAAGGTAA -> GCCAGCTAGCCAAGGTAAA
CGCCCCAACTGAACACGGG -> GCCCCAACTGAACACGGGG
CGCCCCTGTAAGTTTGAGT -> GCCCCTGTAAGTTTGAGTG
CGCCCTTAGACGTGCATTA -> GCCCTTAGACGTGCATTAG
CGCCGCCGGTACGCAATCA -> GCCGCCGGTACGCAATCAT
CGCCGCTACGCTAGACTGC -> GCCGCTACGCTAGACTGCA
CGCCGGTACGCAATCATAC -> GCCGGTACGCAATCATACG
CGCCTCATAAACATAACGA -> GCCTCATAAACATAACGAT
CGCCTTAGCACAGACGGAA -> GCCTTAGCACAGACGGAAT
CGCGAAAGCGTAGGATTCC -> GCGAAAGCGTAGGATTCCT
CGCGATATCATAGATCGTT -> GCGATATCATAGATCGTTC
CGCTACCACAAGGATCGCC -> GCTACCACAAGGATCGCCT
CGCTACGCTAGACTGCAAC -> GCTACGCTAGACTGCAACT
CGCTAGACTGCAACTATCC -> GCTAGACTGCAACTATCCG
CGCTAGAGACCATTGTTTC -> GCTAGAGACCATTGTTTCC
CGCTCCAGACGGCAGCCCC -> GCTCCAGACGGCAGCCCCG
CGCTCCGTCCCGAGAGCGT -> GCTCCGTCCCGAGAGCGTA
CGCTCGTAAGTCAGTAAAT -> GCTCGTAAGTCAGTAAATA
CGCTGCACTTAGTAGCCTT -> GCTGCACTTAGTAGCCTTT
CGCTGGTATGAAGCGTACA -> GCTGGTATGAAGCGTACAC
CGCTTTGCCCAGGGAGAAC -> GCTTTGCCCAGGGAGAACT
CGGAAACACCAAGGTAACA -> GGAAACACCAAGGTAACAT
CGGAACCTTGAGTCGCTCG -> GGAACCTTGAGTCGCTCGT
CGGAAGAACAAACACCTCC -> GGAAGAACAAACACCTCCT
CGGAATAGGCTTAGGGCGT -> GGAATAGGCTTAGGGCGTG
CGGACATGACGGCCTAAGG -> GGACATGACGGCCTAAGGA
CGGACGAGGCTACTGCGAA -> GGACGAGGCTACTGCGAAG
CGGACGGAGAAAGTGGCCT -> GGACGGAGAAAGTGGCCTC
CGGAGAAAGTGGCCTCGAA -> GGAGAAAGTGGCCTCGAAA
CGGAGGCCTATGAACTAGT -> GGAGGCCTATGAACTAGTA
CGGATAGAAGTCGTCGATT -> GGATAGAAGTCGTCGATTA
CGGATCATTCACATACCTT -> GGATCATTCACATACCTTC
CGGATCGTCCACCGTAGCA -> GGATCGTCCACCGTAGCAC
CGGATGCCATCGGCTCCCA -> GGATGCCATCGGCTCCCAC
CGGCAGATGGCACCAAGGC -> GGCAGATGGCACCAAGGCC
CGGCAGCCCCGGTGAGGAT -> GGCAGCCCCGGTGAGGATT
CGGCAGGCACTTCACACAT -> GGCAGGCACTTCACACATT
CGGCCTAAGGAAGATCACA -> GGCCTAAGGAAGATCACAG
CGGCGAGAGACATCTCCAT -> GGCGAGAGACATCTCCATC
CGGCTACGACACCTCCCGT -> GGCTACGACACCTCCCGTA
CGGCTAGTAGTGTGCGAGC -> GGCTAGTAGTGTGCGAGCA
CGGCTCCCACGTCGCTGGT -> GGCTCCCACGTCGCTGGTA
CGGGCATATATGTAAGCAG -> GGGCATATATGTAAGCAGA
CGGGCCATACGCTAGAGAC -> GGGCCATACGCTAGAGACC
CGGGGGTAAATAGTGGTAG -> GGGGGTAAATAGTGGTAGA
CGGGGTTCGCATACCGCTC -> GGGGTTCGCATACCGCTCC
CGGGTCTACATCAAGTCGA -> GGGTCTACATCAAGTCGAT
CGGGTGTAGAAGTCCACGT -> GGGTGTAGAAGTCCACGTC
CGGGTTTACCATCTCGCCG -> GGGTTTACCATCTCGCCGC
CGGTACGCAATCATACGGT -> GGTACGCAATCATACGGTA
CGGTATGCTCTTCAGGCCA -> GGTATGCTCTTCAGGCCAA
CGGTCCTCGTCTGGGAAGG -> GGTCCTCGTCTGGGAAGGA
CGGTGAGGATTGGAAGATG -> GGTGAGGATTGGAAGATGA
CGGTGAGGATTGGAAGCCG -> GGTGAGGATTGGAAGCCGA
CGGTGAGGATTGGAAGGAC -> GGTGAGGATTGGAAGGACC
CGGTGAGGATTGGAAGTGG -> GGTGAGGATTGGAAGTGGA
CGGTGCAATCCTTAAATCC -> GGTGCAATCCTTAAATCCT
CGGTTCGTTACACAACGTC -> GGTTCGTTACACAACGTCA
CGGTTTCGTGGTCCGGCGA -> GGTTTCGTGGTCCGGCGAG
CGTAAGTCAGTAAATATAG -> GTAAGTCAGTAAATATAGG
CGTACACAATTTGCCACAT -> GTACACAATTTGCCACATC
CGTACCTACGCGAAAGCGT -> GTACCTACGCGAAAGCGTA
CGTACTACACCGGGTGTAG -> GTACTACACCGGGTGTAGA
CGTAGCACTGCCTCTAACC -> GTAGCACTGCCTCTAACCG
CGTAGCGGGTTTACCATCT -> GTAGCGGGTTTACCATCTC
CGTAGGATTCCTGGACGAT -> GTAGGATTCCTGGACGATG
CGTATCAACTCATAGGGCA -> GTATCAACTCATAGGGCAG
CGTCACCATCTCGAAACCA -> GTCACCATCTCGAAACCAG
CGTCCACCGTAGCACTGCC -> GTCCACCGTAGCACTGCCT
CGTCCCGAGAGCGTAGCGG -> GTCCCGAGAGCGTAGCGGG
CGTCCTACTTGAATACTGC -> GTCCTACTTGAATACTGCT
CGTCGATTAGGAATAGTTT -> GTCGATTAGGAATAGTTTG
CGTCGCTGGTATGAAGCGT -> GTCGCTGGTATGAAGCGTA
CGTCGTGAATCTGGAACGG -> GTCGTGAATCTGGAACGGA
CGTCTGATAACACTATGAT -> GTCTGATAACACTATGATT
CGTCTGGGAAGGATGCGAG -> GTCTGGGAAGGATGCGAGT
CGTCTGTGTTTTGTGAGTG -> GTCTGTGTTTTGTGAGTGT
CGTGAATCTGGAACGGATG -> GTGAATCTGGAACGGATGC
CGTGATCGGGCATATATGT -> GTGATCGGGCATATATGTA
CGTGCATTAGCTATCCTCA -> GTGCATTAGCTATCCTCAG
CGTGCGCGATATCATAGAT -> GTGCGCGATATCATAGATC
CGTGCGGTTTCGTGGTCCG -> GTGCGGTTTCGTGGTCCGG
CGTGCGTGCGCGATATCAT -> GTGCGTGCGCGATATCATA
CGTGCTCGCCCCAACTGAA -> GTGCTCGCCCCAACTGAAC
CGTGGATAGACAGCTTGCT -> GTGGATAGACAGCTTGCTG
CGTGGCCCATGAGGTCCCC -> GTGGCCCATGAGGTCCCCT
CGTGGCCCTTACATGTACT -> GTGGCCCTTACATGTACTC
CGTGGCTATAGATCCTGCA -> GTGGCTATAGATCCTGCAC
CGTGGTCCGGCGAGAGACA -> GTGGTCCGGCGAGAGACAT
CGTGTCCCGGTGAGGATTG -> GTGTCCCGGTGAGGATTGG
CGTGTTAACGTGGCCCTTA -> GTGTTAACGTGGCCCTTAC
CGTTACACAACGTCACCAT -> GTTACACAACGTCACCATC
CGTTCCAGGCCATGGACTC -> GTTCCAGGCCATGGACTCG
CGTTCCATCTCCTGACTAA -> GTTCCATCTCCTGACTAAA
CGTTCCGCTACCACAAGGA -> GTTCCGCTACCACAAGGAT
CGTTTTACGTCTGTGTTTT -> GTTTTACGTCTGTGTTTTG
CTAAAAATGTAGGACTCGA -> TAAAAATGTAGGACTCGAA
CTAAAGCTCATTAGTTGTA -> TAAAGCTCATTAGTTGTAC
CTAACCGACAACTAAAGCT -> TAACCGACAACTAAAGCTC
CTAACTTCCGCCTTAGCAC -> TAACTTCCGCCTTAGCACA
CTAAGGAAGATCACAGCAA -> TAAGGAAGATCACAGCAAG
CTAATTTGGTGGCTATAGA -> TAATTTGGTGGCTATAGAT
CTACACCGGGTGTAGAAGT -> TACACCGGGTGTAGAAGTC
CTACATCAAGTCGATCGAC -> TACATCAAGTCGATCGACA
CTACCACAAGGATCGCCTC -> TACCACAAGGATCGCCTCA
CTACCCGAATGCCCGGTGA -> TACCCGAATGCCCGGTGAG
CTACGACACCTCCCGTACC -> TACGACACCTCCCGTACCT
CTACGCGAAAGCGTAGGAT -> TACGCGAAAGCGTAGGATT
CTACGCTAGACTGCAACTA -> TACGCTAGACTGCAACTAT
CTACGCTCCGTCCCGAGAG -> TACGCTCCGTCCCGAGAGC
CTACGGGGGTAAATAGTGG -> TACGGGGGTAAATAGTGGT
CTACTGCGAAGTACGTTCC -> TACTGCGAAGTACGTTCCG
CTACTTGAATACTGCTGTG -> TACTTGAATACTGCTGTGT
CTAGAAACTTGCGGAGGCC -> TAGAAACTTGCGGAGGCCT
CTAGACTGCAACTATCCGG -> TAGACTGCAACTATCCGGC
CTAGAGACCATTGTTTCCG -> TAGAGACCATTGTTTCCGT
CTAGCCAAGGTAAAATCTA -> TAGCCAAGGTAAAATCTAC
CTAGGCCCCCGTGCGGTTT -> TAGGCCCCCGTGCGGTTTC
CTAGGTCACCTGATCTCCC -> TAGGTCACCTGATCTCCCG
CTAGTAGTGTGCGAGCAGC -> TAGTAGTGTGCGAGCAGCA
CTAGTATGACAGCTCGGTC -> TAGTATGACAGCTCGGTCC
CTAGTTGGTTGAGCGTCCT -> TAGTTGGTTGAGCGTCCTA
CTATAGATCCTGCACAGAC -> TATAGATCCTGCACAGACT
CTATAGATCCTGCACCTCG -> TATAGATCCTGCACCTCGA
CTATAGATCCTGCACGGGG -> TATAGATCCTGCACGGGGT
CTATAGATCCTGCACTGTA -> TATAGATCCTGCACTGTAT
CTATCCACTGGGTACATGC -> TATCCACTGGGTACATGCT
CTATCCGGCAGGCACTTCA -> TATCCGGCAGGCACTTCAC
CTATCCTCAGAGTTCGGGT -> TATCCTCAGAGTTCGGGTC
CTATCTGTGCAGTCTGACG -> TATCTGTGCAGTCTGACGG
CTATGAACTAGTATGACAG -> TATGAACTAGTATGACAGC
CTATGATGGCCCCGACAGC -> TATGATGGCCCCGACAGCT
CTATGATTGGGAGATCGAC -> TATGATTGGGAGATCGACT
CTATGGACGAAAGCGCCCC -> TATGGACGAAAGCGCCCCT
CTCAAAGGTGGTTGCAACG -> TCAAAGGTGGTTGCAACGT
CTCAGAGTTCGGGTCTACA -> TCAGAGTTCGGGTCTACAT
CTCATAAACATAACGATGT -> TCATAAACATAACGATGTT
CTCATAGGGCAGGAGGTGA -> TCATAGGGCAGGAGGTGAC
CTCATTAGTTGTACAACTT -> TCATTAGTTGTACAACTTC
CTCCAACCAGCTCGACCTA -> TCCAACCAGCTCGACCTAG
CTCCAGACGGCAGCCCCGG -> TCCAGACGGCAGCCCCGGT
CTCCATCTCCCCTTCATGA -> TCCATCTCCCCTTCATGAG
CTCCCACGTCGCTGGTATG -> TCCCACGTCGCTGGTATGA
CTCCCCTTCATGAGACGGA -> TCCCCTTCATGAGACGGAA
CTCCCGAATTTACCGGTTC -> TCCCGAATTTACCGGTTCG
CTCCCGACCTACGCTCCGT -> TCCCGACCTACGCTCCGTC
CTCCCGTACCTACGCGAAA -> TCCCGTACCTACGCGAAAG
CTCCGATAGGTGAAGTGGG -> TCCGATAGGTGAAGTGGGG
CTCCGGCTACGACACCTCC -> TCCGGCTACGACACCTCCC
CTCCGGTGCAATCCTTAAA -> TCCGGTGCAATCCTTAAAT
CTCCGTCCCGAGAGCGTAG -> TCCGTCCCGAGAGCGTAGC
CTCCTAGGTCACCTGATCT -> TCCTAGGTCACCTGATCTC
CTCCTCCCGAATTTACCGG -> TCCTCCCGAATTTACCGGT
CTCCTGACTAAAAATGTAG -> TCCTGACTAAAAATGTAGG
CTCGAAACCAGCAAGCTGG -> TCGAAACCAGCAAGCTGGT
CTCGAAATACGTGGCCCAT -> TCGAAATACGTGGCCCATG
CTCGAAGGCACTGGCTGCA -> TCGAAGGCACTGGCTGCAC
CTCGACCTAGTTGGTTGAG -> TCGACCTAGTTGGTTGAGC
CTCGACGGCAGATGGCACC -> TCGACGGCAGATGGCACCA
CTCGATGCCTATGATGGCC -> TCGATGCCTATGATGGCCC
CTCGATGTCGACCCATCTT -> TCGATGTCGACCCATCTTT
CTCGCCCCAACTGAACACG -> TCGCCCCAACTGAACACGG
CTCGCCGCCGGTACGCAAT -> TCGCCGCCGGTACGCAATC
CTCGCCGCTACGCTAGACT -> TCGCCGCTACGCTAGACTG
CTCGGTCCTCGTCTGGGAA -> TCGGTCCTCGTCTGGGAAG
CTCGTAAGTCAGTAAATAT -> TCGTAAGTCAGTAAATATA
CTCGTCTGGGAAGGATGCG -> TCGTCTGGGAAGGATGCGA
CTCTAACCGACAACTAAAG -> TCTAACCGACAACTAAAGC
CTCTTCAGGCCAAGATAAG -> TCTTCAGGCCAAGATAAGG
CTGAACACGGGGACAGAAG -> TGAACACGGGGACAGAAGT
CTGACCACCGTATCAACTC -> TGACCACCGTATCAACTCA
CTGACGCACTGCTATCTGT -> TGACGCACTGCTATCTGTG
CTGACGGACATGACGGCCT -> TGACGGACATGACGGCCTA
CTGACTAAAAATGTAGGAC -> TGACTAAAAATGTAGGACT
CTGATAACACTATGATTGG -> TGATAACACTATGATTGGG
CTGATCTCCCGACCTACGC -> TGATCTCCCGACCTACGCT
CTGCAACTATCCGGCAGGC -> TGCAACTATCCGGCAGGCA
CTGCAAGGAGTGAAGCGGA -> TGCAAGGAGTGAAGCGGAT
CTGCACAGACTGACCACCG -> TGCACAGACTGACCACCGT
CTGCACCTCGACGGCAGAT -> TGCACCTCGACGGCAGATG
CTGCACGGGGTTCGCATAC -> TGCACGGGGTTCGCATACC
CTGCACTGTATACGCTGCA -> TGCACTGTATACGCTGCAC
CTGCACTTAGTAGCCTTTG -> TGCACTTAGTAGCCTTTGC
CTGCACTTTCGCACCCTGC -> TGCACTTTCGCACCCTGCG
CTGCCTCTAACCGACAACT -> TGCCTCTAACCGACAACTA
CTGCGAAGTACGTTCCGCT -> TGCGAAGTACGTTCCGCTA
CTGCGTGTCCCGGTGAGGA -> TGCGTGTCCCGGTGAGGAT
CTGCTATCTGTGCAGTCTG -> TGCTATCTGTGCAGTCTGA
CTGCTGTGTGGCTTAGAGT -> TGCTGTGTGGCTTAGAGTG
CTGGAACGGATGCCATCGG -> TGGAACGGATGCCATCGGC
CTGGACGATGCCGACTCGC -> TGGACGATGCCGACTCGCC
CTGGAGAGAGTACAGCAAC -> TGGAGAGAGTACAGCAACC
CTGGCCGGCTAGTAGTGTG -> TGGCCGGCTAGTAGTGTGC
CTGGCTGCACTTTCGCACC -> TGGCTGCACTTTCGCACCC
CTGGGAAGGATGCGAGTTC -> TGGGAAGGATGCGAGTTCA
CTGGGTACATGCTACCCGA -> TGGGTACATGCTACCCGAA
CTGGTATGAAGCGTACACA -> TGGTATGAAGCGTACACAA
CTGGTTGTCAACTGTCAAT -> TGGTTGTCAACTGTCAATC
CTGTAAGTTTGAGTGTACG -> TGTAAGTTTGAGTGTACGC
CTGTATACGCTGCACTTAG -> TGTATACGCTGCACTTAGT
CTGTCAATCATTTAGTCAC -> TGTCAATCATTTAGTCACC
CTGTCTTCAATAAGGGGCG -> TGTCTTCAATAAGGGGCGT
CTGTGCAGTCTGACGGACA -> TGTGCAGTCTGACGGACAT
CTGTGTGGCTTAGAGTGAA -> TGTGTGGCTTAGAGTGAAC
CTGTGTTTTGTGAGTGTTC -> TGTGTTTTGTGAGTGTTCT
CTGTTGTACGGAACCTTGA -> TGTTGTACGGAACCTTGAG
CTTAAATCCTTGGGTCCGT -> TTAAATCCTTGGGTCCGTT
CTTACATGTACTCCAACCA -> TTACATGTACTCCAACCAG
CTTAGACGTGCATTAGCTA -> TTAGACGTGCATTAGCTAT
CTTAGAGTGAACTCCGGCT -> TTAGAGTGAACTCCGGCTA
CTTAGCACAGACGGAATAG -> TTAGCACAGACGGAATAGG
CTTAGGGCGTGTTAACGTG -> TTAGGGCGTGTTAACGTGG
CTTAGTAGCCTTTGCATCG -> TTAGTAGCCTTTGCATCGG
CTTATATGGGTGATCGGAC -> TTATATGGGTGATCGGACG
CTTCAACAAAGAGCGCAGG -> TTCAACAAAGAGCGCAGGC
CTTCAATAAGGGGCGTGCT -> TTCAATAAGGGGCGTGCTC
CTTCACACATTGGACACTC -> TTCACACATTGGACACTCA
CTTCAGACGCCAGCTAGCC -> TTCAGACGCCAGCTAGCCA
CTTCAGGCCAAGATAAGGT -> TTCAGGCCAAGATAAGGTG
CTTCATGAGACGGAAGAAC -> TTCATGAGACGGAAGAACA
CTTCCACGGACGGAGAAAG -> TTCCACGGACGGAGAAAGT
CTTCCGCCTTAGCACAGAC -> TTCCGCCTTAGCACAGACG
CTTGAATACTGCTGTGTGG -> TTGAATACTGCTGTGTGGC
CTTGAGTCGCTCGTAAGTC -> TTGAGTCGCTCGTAAGTCA
CTTGATGGGTGCAAGTAGG -> TTGATGGGTGCAAGTAGGA
CTTGCGGAGGCCTATGAAC -> TTGCGGAGGCCTATGAACT
CTTGCTGGCCGGCTAGTAG -> TTGCTGGCCGGCTAGTAGT
CTTGGGTCCGTTCCATCTC -> TTGGGTCCGTTCCATCTCC
CTTGTCCAGTTGTTTGTGT -> TTGTCCAGTTGTTTGTGTG
CTTTCAATGGTCGAGCCTG -> TTTCAATGGTCGAGCCTGG
CTTTCGCACCCTGCGTGTC -> TTTCGCACCCTGCGTGTCC
CTTTGCATCGGATCGTCCA -> TTTGCATCGGATCGTCCAC
CTTTGCCCAGGGAGAACTA -> TTTGCCCAGGGAGAACTAG
CTTTGCGTACTACACCGGG -> TTTGCGTACTACACCGGGT
GAAAATGTGTAAGCGAGAC -> AAAATGTGTAAGCGAGACC
GAAACACCAAGGTAACATC -> AAACACCAAGGTAACATCA
GAAACCAGCAAGCTGGTTG -> AAACCAGCAAGCTGGTTGT
GAAACGGATAGAAGTCGTC -> AAACGGATAGAAGTCGTCG
GAAACTTGCGGAGGCCTAT -> AAACTTGCGGAGGCCTATG
GAAAGCGCCCCTGTAAGTT -> AAAGCGCCCCTGTAAGTTT
GAAAGCGTAGGATTCCTGG -> AAAGCGTAGGATTCCTGGA
GAAAGTGGCCTCGAAATAC -> AAAGTGGCCTCGAAATACG
GAAATACGTGGCCCATGAG -> AAATACGTGGCCCATGAGG
GAACAAACACCTCCTAGGT -> AACAAACACCTCCTAGGTC
GAACCTTCCACGGACGGAG -> AACCTTCCACGGACGGAGA
GAACCTTGAGTCGCTCGTA -> AACCTTGAGTCGCTCGTAA
GAACGGATGCCATCGGCTC -> AACGGATGCCATCGGCTCC
GAACTAGGCCCCCGTGCGG -> AACTAGGCCCCCGTGCGGT
GAACTAGTATGACAGCTCG -> AACTAGTATGACAGCTCGG
GAACTCCGGCTACGACACC -> AACTCCGGCTACGACACCT
GAAGAACAAACACCTCCTA -> AAGAACAAACACCTCCTAG
GAAGACAGGGTGGCTATAG -> AAGACAGGGTGGCTATAGA
GAAGATCACAGCAAGACCC -> AAGATCACAGCAAGACCCA
GAAGATGACGATATCGTGG -> AAGATGACGATATCGTGGC
GAAGCCGAGAGGTAGGTGG -> AAGCCGAGAGGTAGGTGGC
GAAGCGGATCATTCACATA -> AAGCGGATCATTCACATAC
GAAGCGTACACAATTTGCC -> AAGCGTACACAATTTGCCA
GAAGGACCTAATTTGGTGG -> AAGGACCTAATTTGGTGGC
GAAGGATGCGAGTTCAAAT -> AAGGATGCGAGTTCAAATT
GAAGGCACTGGCTGCACTT -> AAGGCACTGGCTGCACTTT
GAAGTACGTTCCGCTACCA -> AAGTACGTTCCGCTACCAC
GAAGTCCACGTCGTGAATC -> AAGTCCACGTCGTGAATCT
GAAGTCGTCGATTAGGAAT -> AAGTCGTCGATTAGGAATA
GAAGTGGAAGACAGGGTGG -> AAGTGGAAGACAGGGTGGC
GAAGTGGGGAACCTTCCAC -> AAGTGGGGAACCTTCCACG
GAATACTGCTGTGTGGCTT -> AATACTGCTGTGTGGCTTA
GAATAGGCTTAGGGCGTGT -> AATAGGCTTAGGGCGTGTT
GAATAGTTTGATCGCTTTG -> AATAGTTTGATCGCTTTGC
GAATCTGGAACGGATGCCA -> AATCTGGAACGGATGCCAT
GAATGCCCGGTGAGGATTG -> AATGCCCGGTGAGGATTGG
GAATTTACCGGTTCGTTAC -> AATTTACCGGTTCGTTACA
GACAACTAAAGCTCATTAG -> ACAACTAAAGCTCATTAGT
GACACCTCCCGTACCTACG -> ACACCTCCCGTACCTACGC
GACACGAAAATGTGTAAGC -> ACACGAAAATGTGTAAGCG
GACACTCAAAGGTGGTTGC -> ACACTCAAAGGTGGTTGCA
GACAGCTCGGTCCTCGTCT -> ACAGCTCGGTCCTCGTCTG
GACAGCTTGCTGGCCGGCT -> ACAGCTTGCTGGCCGGCTA
GACAGCTTTGCGTACTACA -> ACAGCTTTGCGTACTACAC
GACAGGGTGGCTATAGATC -> ACAGGGTGGCTATAGATCC
GACAGGTTGCTGTCTTCAA -> ACAGGTTGCTGTCTTCAAT
GACATCTCCATCTCCCCTT -> ACATCTCCATCTCCCCTTC
GACATGACGGCCTAAGGAA -> ACATGACGGCCTAAGGAAG
GACCACCGTATCAACTCAT -> ACCACCGTATCAACTCATA
GACCATTGTTTCCGTTTTA -> ACCATTGTTTCCGTTTTAC
GACCCATACGCATGATGCG -> ACCCATACGCATGATGCGC
GACCCATCTTTCAATGGTC -> ACCCATCTTTCAATGGTCG
GACCTAATTTGGTGGCTAT -> ACCTAATTTGGTGGCTATA
GACCTACGCTCCGTCCCGA -> ACCTACGCTCCGTCCCGAG
GACCTAGTTGGTTGAGCGT -> ACCTAGTTGGTTGAGCGTC
GACCTCCTCCCGAATTTAC -> ACCTCCTCCCGAATTTACC
GACGAAAGCGCCCCTGTAA -> ACGAAAGCGCCCCTGTAAG
GACGAGGCTACTGCGAAGT -> ACGAGGCTACTGCGAAGTA
GACGATATCGTGGCTATAG -> ACGATATCGTGGCTATAGA
GACGATGCCGACTCGCCGC -> ACGATGCCGACTCGCCGCT
GACGCACTGCTATCTGTGC -> ACGCACTGCTATCTGTGCA
GACGCCAGCTAGCCAAGGT -> ACGCCAGCTAGCCAAGGTA
GACGGAAACACCAAGGTAA -> ACGGAAACACCAAGGTAAC
GACGGAAGAACAAACACCT -> ACGGAAGAACAAACACCTC
GACGGAATAGGCTTAGGGC -> ACGGAATAGGCTTAGGGCG
GACGGACATGACGGCCTAA -> ACGGACATGACGGCCTAAG
GACGGAGAAAGTGGCCTCG -> ACGGAGAAAGTGGCCTCGA
GACGGCAGATGGCACCAAG -> ACGGCAGATGGCACCAAGG
GACGGCAGCCCCGGTGAGG -> ACGGCAGCCCCGGTGAGGA
GACGGCCTAAGGAAGATCA -> ACGGCCTAAGGAAGATCAC
GACGTCTGATAACACTATG -> ACGTCTGATAACACTATGA
GACGTGCATTAGCTATCCT -> ACGTGCATTAGCTATCCTC
GACTAAAAATGTAGGACTC -> ACTAAAAATGTAGGACTCG
GACTAACTTCCGCCTTAGC -> ACTAACTTCCGCCTTAGCA
GACTCGAAGGCACTGGCTG -> ACTCGAAGGCACTGGCTGC
GACTCGATGCCTATGATGG -> ACTCGATGCCTATGATGGC
GACTCGATGTCGACCCATC -> ACTCGATGTCGACCCATCT
GACTCGCCGCTACGCTAGA -> ACTCGCCGCTACGCTAGAC
GACTGACCACCGTATCAAC -> ACTGACCACCGTATCAACT
GACTGCAACTATCCGGCAG -> ACTGCAACTATCCGGCAGG
GACTTGATGGGTGCAAGTA -> ACTTGATGGGTGCAAGTAG
GAGAAAGTGGCCTCGAAAT -> AGAAAGTGGCCTCGAAATA
GAGAACTAGGCCCCCGTGC -> AGAACTAGGCCCCCGTGCG
GAGACATCTCCATCTCCCC -> AGACATCTCCATCTCCCCT
GAGACCATTGTTTCCGTTT -> AGACCATTGTTTCCGTTTT
GAGACCTCCTCCCGAATTT -> AGACCTCCTCCCGAATTTA
GAGACGGAAGAACAAACAC -> AGACGGAAGAACAAACACC
GAGAGACATCTCCATCTCC -> AGAGACATCTCCATCTCCC
GAGAGAGTACAGCAACCCG -> AGAGAGTACAGCAACCCGG
GAGAGCGTAGCGGGTTTAC -> AGAGCGTAGCGGGTTTACC
GAGAGGTAGGTGGCTATAG -> AGAGGTAGGTGGCTATAGA
GAGAGTACAGCAACCCGGT -> AGAGTACAGCAACCCGGTG
GAGATCGACTTGATGGGTG -> AGATCGACTTGATGGGTGC
GAGCAGCAAGATTCTTGTC -> AGCAGCAAGATTCTTGTCC
GAGCCTGGAGAGAGTACAG -> AGCCTGGAGAGAGTACAGC
GAGCGCAGGCCGCCAAATT -> AGCGCAGGCCGCCAAATTG
GAGCGTAGCGGGTTTACCA -> AGCGTAGCGGGTTTACCAT
GAGCGTCCTACTTGAATAC -> AGCGTCCTACTTGAATACT
GAGGATTGGAAGATGACGA -> AGGATTGGAAGATGACGAT
GAGGATTGGAAGCCGAGAG -> AGGATTGGAAGCCGAGAGG
GAGGATTGGAAGGACCTAA -> AGGATTGGAAGGACCTAAT
GAGGATTGGAAGTGGAAGA -> AGGATTGGAAGTGGAAGAC
GAGGCCTATGAACTAGTAT -> AGGCCTATGAACTAGTATG
GAGGCTACTGCGAAGTACG -> AGGCTACTGCGAAGTACGT
GAGGTAGGTGGCTATAGAT -> AGGTAGGTGGCTATAGATC
GAGGTCCCCTTATATGGGT -> AGGTCCCCTTATATGGGTG
GAGGTGACTAACTTCCGCC -> AGGTGACTAACTTCCGCCT
GAGTACAGCAACCCGGTGA -> AGTACAGCAACCCGGTGAG
GAGTCGCTCGTAAGTCAGT -> AGTCGCTCGTAAGTCAGTA
GAGTGAACTCCGGCTACGA -> AGTGAACTCCGGCTACGAC
GAGTGAAGCGGATCATTCA -> AGTGAAGCGGATCATTCAC
GAGTGTACGCACAACTAGA -> AGTGTACGCACAACTAGAA
GAGTGTTCTGTTGTACGGA -> AGTGTTCTGTTGTACGGAA
GAGTTCAAATTGCTATCCA -> AGTTCAAATTGCTATCCAC
GAGTTCGGGTCTACATCAA -> AGTTCGGGTCTACATCAAG
GATAACACCTGACGCACTG -> ATAACACCTGACGCACTGC
GATAACACTATGATTGGGA -> ATAACACTATGATTGGGAG
GATAAGGTGTTTAGACGTC -> ATAAGGTGTTTAGACGTCT
GATAGAAGTCGTCGATTAG -> ATAGAAGTCGTCGATTAGG
GATAGACAGCTTGCTGGCC -> ATAGACAGCTTGCTGGCCG
GATAGGTGAAGTGGGGAAC -> ATAGGTGAAGTGGGGAACC
GATATCATAGATCGTTCCA -> ATATCATAGATCGTTCCAG
GATATCGTGGCTATAGATC -> ATATCGTGGCTATAGATCC
GATCACAGCAAGACCCATA -> ATCACAGCAAGACCCATAC
GATCATTCACATACCTTCA -> ATCATTCACATACCTTCAG
GATCCTGCACAGACTGACC -> ATCCTGCACAGACTGACCA
GATCCTGCACCTCGACGGC -> ATCCTGCACCTCGACGGCA
GATCCTGCACGGGGTTCGC -> ATCCTGCACGGGGTTCGCA
GATCCTGCACTGTATACGC -> ATCCTGCACTGTATACGCT
GATCGACAGGTTGCTGTCT -> ATCGACAGGTTGCTGTCTT
GATCGACTTGATGGGTGCA -> ATCGACTTGATGGGTGCAA
GATCGCCTCATAAACATAA -> ATCGCCTCATAAACATAAC
GATCGCTTTGCCCAGGGAG -> ATCGCTTTGCCCAGGGAGA
GATCGGACGAGGCTACTGC -> ATCGGACGAGGCTACTGCG
GATCGGGCATATATGTAAG -> ATCGGGCATATATGTAAGC
GATCGTCCACCGTAGCACT -> ATCGTCCACCGTAGCACTG
GATCGTTCCAGGCCATGGA -> ATCGTTCCAGGCCATGGAC
GATCTCCCGACCTACGCTC -> ATCTCCCGACCTACGCTCC
GATGACGATATCGTGGCTA -> ATGACGATATCGTGGCTAT
GATGCCATCGGCTCCCACG -> ATGCCATCGGCTCCCACGT
GATGCCGACTCGCCGCTAC -> ATGCCGACTCGCCGCTACG
GATGCCTATGATGGCCCCG -> ATGCCTATGATGGCCCCGA
GATGCGAGTTCAAATTGCT -> ATGCGAGTTCAAATTGCTA
GATGCGCAAATCGTGATCG -> ATGCGCAAATCGTGATCGG
GATGGCACCAAGGCCTCCG -> ATGGCACCAAGGCCTCCGG
GATGGCCCCGACAGCTTTG -> ATGGCCCCGACAGCTTTGC
GATGGGTGCAAGTAGGACT -> ATGGGTGCAAGTAGGACTC
GATGTCGACCCATCTTTCA -> ATGTCGACCCATCTTTCAA
GATGTTACAGCCGCCCTTA -> ATGTTACAGCCGCCCTTAG
GATTAGGAATAGTTTGATC -> ATTAGGAATAGTTTGATCG
GATTCCTGGACGATGCCGA -> ATTCCTGGACGATGCCGAC
GATTCTTGTCCAGTTGTTT -> ATTCTTGTCCAGTTGTTTG
GATTGGAAGATGACGATAT -> ATTGGAAGATGACGATATC
GATTGGAAGCCGAGAGGTA -> ATTGGAAGCCGAGAGGTAG
GATTGGAAGGACCTAATTT -> ATTGGAAGGACCTAATTTG
GATTGGAAGTGGAAGACAG -> ATTGGAAGTGGAAGACAGG
GATTGGGAGATCGACTTGA -> ATTGGGAGATCGACTTGAT
GCAAATCGTGATCGGGCAT -> CAAATCGTGATCGGGCATA
GCAACCCGGTGAGGATTGG -> CAACCCGGTGAGGATTGGA
GCAACGTGGATAGACAGCT -> CAACGTGGATAGACAGCTT
GCAACTATCCGGCAGGCAC -> CAACTATCCGGCAGGCACT
GCAAGACCCATACGCATGA -> CAAGACCCATACGCATGAT
GCAAGATTCTTGTCCAGTT -> CAAGATTCTTGTCCAGTTG
GCAAGCTGGTTGTCAACTG -> CAAGCTGGTTGTCAACTGT
GCAAGGAGTGAAGCGGATC -> CAAGGAGTGAAGCGGATCA
GCAAGTAGGACTCGATGCC -> CAAGTAGGACTCGATGCCT
GCAATCATACGGTATGCTC -> CAATCATACGGTATGCTCT
GCAATCCTTAAATCCTTGG -> CAATCCTTAAATCCTTGGG
GCACAACTAGAAACTTGCG -> CACAACTAGAAACTTGCGG
GCACAACTGCAAGGAGTGA -> CACAACTGCAAGGAGTGAA
GCACAGACGGAATAGGCTT -> CACAGACGGAATAGGCTTA
GCACAGACTGACCACCGTA -> CACAGACTGACCACCGTAT
GCACCAAGGCCTCCGGTGC -> CACCAAGGCCTCCGGTGCA
GCACCCTGCGTGTCCCGGT -> CACCCTGCGTGTCCCGGTG
GCACCTCGACGGCAGATGG -> CACCTCGACGGCAGATGGC
GCACGGGGTTCGCATACCG -> CACGGGGTTCGCATACCGC
GCACTGCCTCTAACCGACA -> CACTGCCTCTAACCGACAA
GCACTGCTATCTGTGCAGT -> CACTGCTATCTGTGCAGTC
GCACTGGCTGCACTTTCGC -> CACTGGCTGCACTTTCGCA
GCACTGTATACGCTGCACT -> CACTGTATACGCTGCACTT
GCACTTAGTAGCCTTTGCA -> CACTTAGTAGCCTTTGCAT
GCACTTCACACATTGGACA -> CACTTCACACATTGGACAC
GCACTTTCGCACCCTGCGT -> CACTTTCGCACCCTGCGTG
GCAGACACGAAAATGTGTA -> CAGACACGAAAATGTGTAA
GCAGATGGCACCAAGGCCT -> CAGATGGCACCAAGGCCTC
GCAGCAAGATTCTTGTCCA -> CAGCAAGATTCTTGTCCAG
GCAGCCCCGGTGAGGATTG -> CAGCCCCGGTGAGGATTGG
GCAGGAGGTGACTAACTTC -> CAGGAGGTGACTAACTTCC
GCAGGCACTTCACACATTG -> CAGGCACTTCACACATTGG
GCAGGCCGCCAAATTGACG -> CAGGCCGCCAAATTGACGG
GCAGTCTGACGGACATGAC -> CAGTCTGACGGACATGACG
GCATACCGCTCCAGACGGC -> CATACCGCTCCAGACGGCA
GCATATATGTAAGCAGACA -> CATATATGTAAGCAGACAC
GCATCGGATCGTCCACCGT -> CATCGGATCGTCCACCGTA
GCATGATGCGCAAATCGTG -> CATGATGCGCAAATCGTGA
GCATTAGCTATCCTCAGAG -> CATTAGCTATCCTCAGAGT
GCCAAATTGACGGAAACAC -> CCAAATTGACGGAAACACC
GCCAAGATAAGGTGTTTAG -> CCAAGATAAGGTGTTTAGA
GCCAAGGTAAAATCTACGG -> CCAAGGTAAAATCTACGGG
GCCACATCATCGGGCCATA -> CCACATCATCGGGCCATAC
GCCAGCTAGCCAAGGTAAA -> CCAGCTAGCCAAGGTAAAA
GCCATACGCTAGAGACCAT -> CCATACGCTAGAGACCATT
GCCATCGGCTCCCACGTCG -> CCATCGGCTCCCACGTCGC
GCCATGGACTCGATGTCGA -> CCATGGACTCGATGTCGAC
GCCCAGGGAGAACTAGGCC -> CCCAGGGAGAACTAGGCCC
GCCCATGAGGTCCCCTTAT -> CCCATGAGGTCCCCTTATA
GCCCCAACTGAACACGGGG -> CCCCAACTGAACACGGGGA
GCCCCCGTGCGGTTTCGTG -> CCCCCGTGCGGTTTCGTGG
GCCCCGACAGCTTTGCGTA -> CCCCGACAGCTTTGCGTAC
GCCCCGGTGAGGATTGGAA -> CCCCGGTGAGGATTGGAAG
GCCCCTGTAAGTTTGAGTG -> CCCCTGTAAGTTTGAGTGT
GCCCGGTGAGGATTGGAAG -> CCCGGTGAGGATTGGAAGG
GCCCTTACATGTACTCCAA -> CCCTTACATGTACTCCAAC
GCCCTTAGACGTGCATTAG -> CCCTTAGACGTGCATTAGC
GCCGACTCGCCGCTACGCT -> CCGACTCGCCGCTACGCTA
GCCGAGAGGTAGGTGGCTA -> CCGAGAGGTAGGTGGCTAT
GCCGCCAAATTGACGGAAA -> CCGCCAAATTGACGGAAAC
GCCGCCCTTAGACGTGCAT -> CCGCCCTTAGACGTGCATT
GCCGCCGGTACGCAATCAT -> CCGCCGGTACGCAATCATA
GCCGCTACGCTAGACTGCA -> CCGCTACGCTAGACTGCAA
GCCGGCTAGTAGTGTGCGA -> CCGGCTAGTAGTGTGCGAG
GCCGGTACGCAATCATACG -> CCGGTACGCAATCATACGG
GCCTAAGGAAGATCACAGC -> CCTAAGGAAGATCACAGCA
GCCTATGAACTAGTATGAC -> CCTATGAACTAGTATGACA
GCCTATGATGGCCCCGACA -> CCTATGATGGCCCCGACAG
GCCTCATAAACATAACGAT -> CCTCATAAACATAACGATG
GCCTCCGGTGCAATCCTTA -> CCTCCGGTGCAATCCTTAA
GCCTCGAAATACGTGGCCC -> CCTCGAAATACGTGGCCCA
GCCTCTAACCGACAACTAA -> CCTCTAACCGACAACTAAA
GCCTGGAGAGAGTACAGCA -> CCTGGAGAGAGTACAGCAA
GCCTTAGCACAGACGGAAT -> CCTTAGCACAGACGGAATA
GCCTTTGCATCGGATCGTC -> CCTTTGCATCGGATCGTCC
GCGAAAGCGTAGGATTCCT -> CGAAAGCGTAGGATTCCTG
GCGAAGTACGTTCCGCTAC -> CGAAGTACGTTCCGCTACC
GCGAGACCTCCTCCCGAAT -> CGAGACCTCCTCCCGAATT
GCGAGAGACATCTCCATCT -> CGAGAGACATCTCCATCTC
GCGAGCAGCAAGATTCTTG -> CGAGCAGCAAGATTCTTGT
GCGAGTTCAAATTGCTATC -> CGAGTTCAAATTGCTATCC
GCGATATCATAGATCGTTC -> CGATATCATAGATCGTTCC
GCGCAAATCGTGATCGGGC -> CGCAAATCGTGATCGGGCA
GCGCAGGCCGCCAAATTGA -> CGCAGGCCGCCAAATTGAC
GCGCCCCTGTAAGTTTGAG -> CGCCCCTGTAAGTTTGAGT
GCGCGATATCATAGATCGT -> CGCGATATCATAGATCGTT
GCGGAGGCCTATGAACTAG -> CGGAGGCCTATGAACTAGT
GCGGATCATTCACATACCT -> CGGATCATTCACATACCTT
GCGGGTTTACCATCTCGCC -> CGGGTTTACCATCTCGCCG
GCGGTTTCGTGGTCCGGCG -> CGGTTTCGTGGTCCGGCGA
GCGTACACAATTTGCCACA -> CGTACACAATTTGCCACAT
GCGTACTACACCGGGTGTA -> CGTACTACACCGGGTGTAG
GCGTAGCGGGTTTACCATC -> CGTAGCGGGTTTACCATCT
GCGTAGGATTCCTGGACGA -> CGTAGGATTCCTGGACGAT
GCGTCCTACTTGAATACTG -> CGTCCTACTTGAATACTGC
GCGTGCGCGATATCATAGA -> CGTGCGCGATATCATAGAT
GCGTGCTCGCCCCAACTGA -> CGTGCTCGCCCCAACTGAA
GCGTGTCCCGGTGAGGATT -> CGTGTCCCGGTGAGGATTG
GCGTGTTAACGTGGCCCTT -> CGTGTTAACGTGGCCCTTA
GCTACCACAAGGATCGCCT -> CTACCACAAGGATCGCCTC
GCTACCCGAATGCCCGGTG -> CTACCCGAATGCCCGGTGA
GCTACGACACCTCCCGTAC -> CTACGACACCTCCCGTACC
GCTACGCTAGACTGCAACT -> CTACGCTAGACTGCAACTA
GCTACTGCGAAGTACGTTC -> CTACTGCGAAGTACGTTCC
GCTAGACTGCAACTATCCG -> CTAGACTGCAACTATCCGG
GCTAGAGACCATTGTTTCC -> CTAGAGACCATTGTTTCCG
GCTAGCCAAGGTAAAATCT -> CTAGCCAAGGTAAAATCTA
GCTAGTAGTGTGCGAGCAG -> CTAGTAGTGTGCGAGCAGC
GCTATAGATCCTGCACAGA -> CTATAGATCCTGCACAGAC
GCTATAGATCCTGCACCTC -> CTATAGATCCTGCACCTCG
GCTATAGATCCTGCACGGG -> CTATAGATCCTGCACGGGG
GCTATAGATCCTGCACTGT -> CTATAGATCCTGCACTGTA
GCTATCCACTGGGTACATG -> CTATCCACTGGGTACATGC
GCTATCCTCAGAGTTCGGG -> CTATCCTCAGAGTTCGGGT
GCTATCTGTGCAGTCTGAC -> CTATCTGTGCAGTCTGACG
GCTATGGACGAAAGCGCCC -> CTATGGACGAAAGCGCCCC
GCTCATTAGTTGTACAACT -> CTCATTAGTTGTACAACTT
GCTCCAGACGGCAGCCCCG -> CTCCAGACGGCAGCCCCGG
GCTCCCACGTCGCTGGTAT -> CTCCCACGTCGCTGGTATG
GCTCCGTCCCGAGAGCGTA -> CTCCGTCCCGAGAGCGTAG
GCTCGACCTAGTTGGTTGA -> CTCGACCTAGTTGGTTGAG
GCTCGCCCCAACTGAACAC -> CTCGCCCCAACTGAACACG
GCTCGGTCCTCGTCTGGGA -> CTCGGTCCTCGTCTGGGAA
GCTCGTAAGTCAGTAAATA -> CTCGTAAGTCAGTAAATAT
GCTCTTCAGGCCAAGATAA -> CTCTTCAGGCCAAGATAAG
GCTGCACTTAGTAGCCTTT -> CTGCACTTAGTAGCCTTTG
GCTGCACTTTCGCACCCTG -> CTGCACTTTCGCACCCTGC
GCTGGCCGGCTAGTAGTGT -> CTGGCCGGCTAGTAGTGTG
GCTGGTATGAAGCGTACAC -> CTGGTATGAAGCGTACACA
GCTGGTTGTCAACTGTCAA -> CTGGTTGTCAACTGTCAAT
GCTGTCTTCAATAAGGGGC -> CTGTCTTCAATAAGGGGCG
GCTGTGTGGCTTAGAGTGA -> CTGTGTGGCTTAGAGTGAA
GCTTAGAGTGAACTCCGGC -> CTTAGAGTGAACTCCGGCT
GCTTAGGGCGTGTTAACGT -> CTTAGGGCGTGTTAACGTG
GCTTGCTGGCCGGCTAGTA -> CTTGCTGGCCGGCTAGTAG
GCTTTGCCCAGGGAGAACT -> CTTTGCCCAGGGAGAACTA
GCTTTGCGTACTACACCGG -> CTTTGCGTACTACACCGGG
GGAAACACCAAGGTAACAT -> GAAACACCAAGGTAACATC
GGAACCTTCCACGGACGGA -> GAACCTTCCACGGACGGAG
GGAACCTTGAGTCGCTCGT -> GAACCTTGAGTCGCTCGTA
GGAACGGATGCCATCGGCT -> GAACGGATGCCATCGGCTC
GGAAGAACAAACACCTCCT -> GAAGAACAAACACCTCCTA
GGAAGACAGGGTGGCTATA -> GAAGACAGGGTGGCTATAG
GGAAGATCACAGCAAGACC -> GAAGATCACAGCAAGACCC
GGAAGATGACGATATCGTG -> GAAGATGACGATATCGTGG
GGAAGCCGAGAGGTAGGTG -> GAAGCCGAGAGGTAGGTGG
GGAAGGACCTAATTTGGTG -> GAAGGACCTAATTTGGTGG
GGAAGGATGCGAGTTCAAA -> GAAGGATGCGAGTTCAAAT
GGAAGTGGAAGACAGGGTG -> GAAGTGGAAGACAGGGTGG
GGAATAGGCTTAGGGCGTG -> GAATAGGCTTAGGGCGTGT
GGAATAGTTTGATCGCTTT -> GAATAGTTTGATCGCTTTG
GGACACTCAAAGGTGGTTG -> GACACTCAAAGGTGGTTGC
GGACATGACGGCCTAAGGA -> GACATGACGGCCTAAGGAA
GGACCTAATTTGGTGGCTA -> GACCTAATTTGGTGGCTAT
GGACGAAAGCGCCCCTGTA -> GACGAAAGCGCCCCTGTAA
GGACGAGGCTACTGCGAAG -> GACGAGGCTACTGCGAAGT
GGACGATGCCGACTCGCCG -> GACGATGCCGACTCGCCGC
GGACGGAGAAAGTGGCCTC -> GACGGAGAAAGTGGCCTCG
GGACTCGAAGGCACTGGCT -> GACTCGAAGGCACTGGCTG
GGACTCGATGCCTATGATG -> GACTCGATGCCTATGATGG
GGACTCGATGTCGACCCAT -> GACTCGATGTCGACCCATC
GGAGAAAGTGGCCTCGAAA -> GAGAAAGTGGCCTCGAAAT
GGAGAACTAGGCCCCCGTG -> GAGAACTAGGCCCCCGTGC
GGAGAGAGTACAGCAACCC -> GAGAGAGTACAGCAACCCG
GGAGATCGACTTGATGGGT -> GAGATCGACTTGATGGGTG
GGAGGCCTATGAACTAGTA -> GAGGCCTATGAACTAGTAT
GGAGGTGACTAACTTCCGC -> GAGGTGACTAACTTCCGCC
GGAGTGAAGCGGATCATTC -> GAGTGAAGCGGATCATTCA
GGATAACACCTGACGCACT -> GATAACACCTGACGCACTG
GGATAGAAGTCGTCGATTA -> GATAGAAGTCGTCGATTAG
GGATAGACAGCTTGCTGGC -> GATAGACAGCTTGCTGGCC
GGATCATTCACATACCTTC -> GATCATTCACATACCTTCA
GGATCGCCTCATAAACATA -> GATCGCCTCATAAACATAA
GGATCGTCCACCGTAGCAC -> GATCGTCCACCGTAGCACT
GGATGCCATCGGCTCCCAC -> GATGCCATCGGCTCCCACG
GGATGCGAGTTCAAATTGC -> GATGCGAGTTCAAATTGCT
GGATTCCTGGACGATGCCG -> GATTCCTGGACGATGCCGA
GGATTGGAAGATGACGATA -> GATTGGAAGATGACGATAT
GGATTGGAAGCCGAGAGGT -> GATTGGAAGCCGAGAGGTA
GGATTGGAAGGACCTAATT -> GATTGGAAGGACCTAATTT
GGATTGGAAGTGGAAGACA -> GATTGGAAGTGGAAGACAG
GGCACCAAGGCCTCCGGTG -> GCACCAAGGCCTCCGGTGC
GGCACTGGCTGCACTTTCG -> GCACTGGCTGCACTTTCGC
GGCACTTCACACATTGGAC -> GCACTTCACACATTGGACA
GGCAGATGGCACCAAGGCC -> GCAGATGGCACCAAGGCCT
GGCAGCCCCGGTGAGGATT -> GCAGCCCCGGTGAGGATTG
GGCAGGAGGTGACTAACTT -> GCAGGAGGTGACTAACTTC
GGCAGGCACTTCACACATT -> GCAGGCACTTCACACATTG
GGCATATATGTAAGCAGAC -> GCATATATGTAAGCAGACA
GGCCAAGATAAGGTGTTTA -> GCCAAGATAAGGTGTTTAG
GGCCATACGCTAGAGACCA -> GCCATACGCTAGAGACCAT
GGCCATGGACTCGATGTCG -> GCCATGGACTCGATGTCGA
GGCCCATGAGGTCCCCTTA -> GCCCATGAGGTCCCCTTAT
GGCCCCCGTGCGGTTTCGT -> GCCCCCGTGCGGTTTCGTG
GGCCCCGACAGCTTTGCGT -> GCCCCGACAGCTTTGCGTA
GGCCCTTACATGTACTCCA -> GCCCTTACATGTACTCCAA
GGCCGCCAAATTGACGGAA -> GCCGCCAAATTGACGGAAA
GGCCGGCTAGTAGTGTGCG -> GCCGGCTAGTAGTGTGCGA
GGCCTAAGGAAGATCACAG -> GCCTAAGGAAGATCACAGC
GGCCTATGAACTAGTATGA -> GCCTATGAACTAGTATGAC
GGCCTCCGGTGCAATCCTT -> GCCTCCGGTGCAATCCTTA
GGCCTCGAAATACGTGGCC -> GCCTCGAAATACGTGGCCC
GGCGAGAGACATCTCCATC -> GCGAGAGACATCTCCATCT
GGCGTGCTCGCCCCAACTG -> GCGTGCTCGCCCCAACTGA
GGCGTGTTAACGTGGCCCT -> GCGTGTTAACGTGGCCCTT
GGCTACGACACCTCCCGTA -> GCTACGACACCTCCCGTAC
GGCTACTGCGAAGTACGTT -> GCTACTGCGAAGTACGTTC
GGCTAGTAGTGTGCGAGCA -> GCTAGTAGTGTGCGAGCAG
GGCTATAGATCCTGCACAG -> GCTATAGATCCTGCACAGA
GGCTATAGATCCTGCACCT -> GCTATAGATCCTGCACCTC
GGCTATAGATCCTGCACGG -> GCTATAGATCCTGCACGGG
GGCTATAGATCCTGCACTG -> GCTATAGATCCTGCACTGT
GGCTCCCACGTCGCTGGTA -> GCTCCCACGTCGCTGGTAT
GGCTGCACTTTCGCACCCT -> GCTGCACTTTCGCACCCTG
GGCTTAGAGTGAACTCCGG -> GCTTAGAGTGAACTCCGGC
GGCTTAGGGCGTGTTAACG -> GCTTAGGGCGTGTTAACGT
GGGAACCTTCCACGGACGG -> GGAACCTTCCACGGACGGA
GGGAAGGATGCGAGTTCAA -> GGAAGGATGCGAGTTCAAA
GGGAGAACTAGGCCCCCGT -> GGAGAACTAGGCCCCCGTG
GGGAGATCGACTTGATGGG -> GGAGATCGACTTGATGGGT
GGGCAGGAGGTGACTAACT -> GGCAGGAGGTGACTAACTT
GGGCATATATGTAAGCAGA -> GGCATATATGTAAGCAGAC
GGGCCATACGCTAGAGACC -> GGCCATACGCTAGAGACCA
GGGCGTGCTCGCCCCAACT -> GGCGTGCTCGCCCCAACTG
GGGCGTGTTAACGTGGCCC -> GGCGTGTTAACGTGGCCCT
GGGGAACCTTCCACGGACG -> GGGAACCTTCCACGGACGG
GGGGCGTGCTCGCCCCAAC -> GGGCGTGCTCGCCCCAACT
GGGGGTAAATAGTGGTAGA -> GGGGTAAATAGTGGTAGAA
GGGGTAAATAGTGGTAGAA -> GGGTAAATAGTGGTAGAAA
GGGGTTCGCATACCGCTCC -> GGGTTCGCATACCGCTCCA
GGGTAAATAGTGGTAGAAA -> GGTAAATAGTGGTAGAAAC
GGGTACATGCTACCCGAAT -> GGTACATGCTACCCGAATG
GGGTCCGTTCCATCTCCTG -> GGTCCGTTCCATCTCCTGA
GGGTCTACATCAAGTCGAT -> GGTCTACATCAAGTCGATC
GGGTGATCGGACGAGGCTA -> GGTGATCGGACGAGGCTAC
GGGTGCAAGTAGGACTCGA -> GGTGCAAGTAGGACTCGAT
GGGTGGCTATAGATCCTGC -> GGTGGCTATAGATCCTGCA
GGGTGTAGAAGTCCACGTC -> GGTGTAGAAGTCCACGTCG
GGGTTCGCATACCGCTCCA -> GGTTCGCATACCGCTCCAG
GGGTTTACCATCTCGCCGC -> GGTTTACCATCTCGCCGCC
GGTAAAATCTACGGGGGTA -> GTAAAATCTACGGGGGTAA
GGTAAATAGTGGTAGAAAC -> GTAAATAGTGGTAGAAACG
GGTAACATCACTCCGATAG -> GTAACATCACTCCGATAGG
GGTACATGCTACCCGAATG -> GTACATGCTACCCGAATGC
GGTACGCAATCATACGGTA -> GTACGCAATCATACGGTAT
GGTAGAAACGGATAGAAGT -> GTAGAAACGGATAGAAGTC
GGTAGGTGGCTATAGATCC -> GTAGGTGGCTATAGATCCT
GGTATGAAGCGTACACAAT -> GTATGAAGCGTACACAATT
GGTATGCTCTTCAGGCCAA -> GTATGCTCTTCAGGCCAAG
GGTCACCTGATCTCCCGAC -> GTCACCTGATCTCCCGACC
GGTCCCCTTATATGGGTGA -> GTCCCCTTATATGGGTGAT
GGTCCGGCGAGAGACATCT -> GTCCGGCGAGAGACATCTC
GGTCCGTTCCATCTCCTGA -> GTCCGTTCCATCTCCTGAC
GGTCCTCGTCTGGGAAGGA -> GTCCTCGTCTGGGAAGGAT
GGTCGAGCCTGGAGAGAGT -> GTCGAGCCTGGAGAGAGTA
GGTCTACATCAAGTCGATC -> GTCTACATCAAGTCGATCG
GGTGAAGTGGGGAACCTTC -> GTGAAGTGGGGAACCTTCC
GGTGACTAACTTCCGCCTT -> GTGACTAACTTCCGCCTTA
GGTGAGGATTGGAAGATGA -> GTGAGGATTGGAAGATGAC
GGTGAGGATTGGAAGCCGA -> GTGAGGATTGGAAGCCGAG
GGTGAGGATTGGAAGGACC -> GTGAGGATTGGAAGGACCT
GGTGAGGATTGGAAGTGGA -> GTGAGGATTGGAAGTGGAA
GGTGATCGGACGAGGCTAC -> GTGATCGGACGAGGCTACT
GGTGCAAGTAGGACTCGAT -> GTGCAAGTAGGACTCGATG
GGTGCAATCCTTAAATCCT -> GTGCAATCCTTAAATCCTT
GGTGGCTATAGATCCTGCA -> GTGGCTATAGATCCTGCAC,GTGGCTATAGATCCTGCAC,GTGGCTATAGATCCTGCAC
GGTGGTTGCAACGTGGATA -> GTGGTTGCAACGTGGATAG
GGTGTAGAAGTCCACGTCG -> GTGTAGAAGTCCACGTCGT
GGTGTTTAGACGTCTGATA -> GTGTTTAGACGTCTGATAA
GGTTCGCATACCGCTCCAG -> GTTCGCATACCGCTCCAGA
GGTTCGTTACACAACGTCA -> GTTCGTTACACAACGTCAC
GGTTGAGCGTCCTACTTGA -> GTTGAGCGTCCTACTTGAA
GGTTGCAACGTGGATAGAC -> GTTGCAACGTGGATAGACA
GGTTGCTGTCTTCAATAAG -> GTTGCTGTCTTCAATAAGG
GGTTGTCAACTGTCAATCA -> GTTGTCAACTGTCAATCAT
GGTTTACCATCTCGCCGCC -> GTTTACCATCTCGCCGCCG
GGTTTCGTGGTCCGGCGAG -> GTTTCGTGGTCCGGCGAGA
GTAAAATCTACGGGGGTAA -> TAAAATCTACGGGGGTAAA
GTAAATAGTGGTAGAAACG -> TAAATAGTGGTAGAAACGG
GTAAATATAGGATAACACC -> TAAATATAGGATAACACCT
GTAACATCACTCCGATAGG -> TAACATCACTCCGATAGGT
GTAAGCAGACACGAAAATG -> TAAGCAGACACGAAAATGT
GTAAGCGAGACCTCCTCCC -> TAAGCGAGACCTCCTCCCG
GTAAGTCAGTAAATATAGG -> TAAGTCAGTAAATATAGGA
GTAAGTTTGAGTGTACGCA -> TAAGTTTGAGTGTACGCAC
GTACAACTTCAACAAAGAG -> TACAACTTCAACAAAGAGC
GTACACAATTTGCCACATC -> TACACAATTTGCCACATCA
GTACAGCAACCCGGTGAGG -> TACAGCAACCCGGTGAGGA
GTACATGCTACCCGAATGC -> TACATGCTACCCGAATGCC
GTACCTACGCGAAAGCGTA -> TACCTACGCGAAAGCGTAG
GTACGCAATCATACGGTAT -> TACGCAATCATACGGTATG
GTACGCACAACTAGAAACT -> TACGCACAACTAGAAACTT
GTACGGAACCTTGAGTCGC -> TACGGAACCTTGAGTCGCT
GTACGTTCCGCTACCACAA -> TACGTTCCGCTACCACAAG
GTACTACACCGGGTGTAGA -> TACTACACCGGGTGTAGAA
GTACTCCAACCAGCTCGAC -> TACTCCAACCAGCTCGACC
GTAGAAACGGATAGAAGTC -> TAGAAACGGATAGAAGTCG
GTAGAAGTCCACGTCGTGA -> TAGAAGTCCACGTCGTGAA
GTAGCACTGCCTCTAACCG -> TAGCACTGCCTCTAACCGA
GTAGCCTTTGCATCGGATC -> TAGCCTTTGCATCGGATCG
GTAGCGGGTTTACCATCTC -> TAGCGGGTTTACCATCTCG
GTAGGACTCGAAGGCACTG -> TAGGACTCGAAGGCACTGG
GTAGGACTCGATGCCTATG -> TAGGACTCGATGCCTATGA
GTAGGATTCCTGGACGATG -> TAGGATTCCTGGACGATGC
GTAGGTGGCTATAGATCCT -> TAGGTGGCTATAGATCCTG
GTAGTGTGCGAGCAGCAAG -> TAGTGTGCGAGCAGCAAGA
GTATACGCTGCACTTAGTA -> TATACGCTGCACTTAGTAG
GTATCAACTCATAGGGCAG -> TATCAACTCATAGGGCAGG
GTATGAAGCGTACACAATT -> TATGAAGCGTACACAATTT
GTATGACAGCTCGGTCCTC -> TATGACAGCTCGGTCCTCG
GTATGCTCTTCAGGCCAAG -> TATGCTCTTCAGGCCAAGA
GTCAACTGTCAATCATTTA -> TCAACTGTCAATCATTTAG
GTCAATCATTTAGTCACCG -> TCAATCATTTAGTCACCGT
GTCACCATCTCGAAACCAG -> TCACCATCTCGAAACCAGC
GTCACCGTGCGTGCGCGAT -> TCACCGTGCGTGCGCGATA
GTCACCTGATCTCCCGACC -> TCACCTGATCTCCCGACCT
GTCAGTAAATATAGGATAA -> TCAGTAAATATAGGATAAC
GTCCACCGTAGCACTGCCT -> TCCACCGTAGCACTGCCTC
GTCCACGTCGTGAATCTGG -> TCCACGTCGTGAATCTGGA
GTCCAGTTGTTTGTGTGCT -> TCCAGTTGTTTGTGTGCTA
GTCCCCTTATATGGGTGAT -> TCCCCTTATATGGGTGATC
GTCCCGAGAGCGTAGCGGG -> TCCCGAGAGCGTAGCGGGT
GTCCCGGTGAGGATTGGAA -> TCCCGGTGAGGATTGGAAG
GTCCGGCGAGAGACATCTC -> TCCGGCGAGAGACATCTCC
GTCCGTTCCATCTCCTGAC -> TCCGTTCCATCTCCTGACT
GTCCTACTTGAATACTGCT -> TCCTACTTGAATACTGCTG
GTCCTCGTCTGGGAAGGAT -> TCCTCGTCTGGGAAGGATG
GTCGACCCATCTTTCAATG -> TCGACCCATCTTTCAATGG
GTCGAGCCTGGAGAGAGTA -> TCGAGCCTGGAGAGAGTAC
GTCGATCGACAGGTTGCTG -> TCGATCGACAGGTTGCTGT
GTCGATTAGGAATAGTTTG -> TCGATTAGGAATAGTTTGA
GTCGCTCGTAAGTCAGTAA -> TCGCTCGTAAGTCAGTAAA
GTCGCTGGTATGAAGCGTA -> TCGCTGGTATGAAGCGTAC
GTCGTCGATTAGGAATAGT -> TCGTCGATTAGGAATAGTT
GTCGTGAATCTGGAACGGA -> TCGTGAATCTGGAACGGAT
GTCTACATCAAGTCGATCG -> TCTACATCAAGTCGATCGA
GTCTGACGGACATGACGGC -> TCTGACGGACATGACGGCC
GTCTGATAACACTATGATT -> TCTGATAACACTATGATTG
GTCTGGGAAGGATGCGAGT -> TCTGGGAAGGATGCGAGTT
GTCTGTGTTTTGTGAGTGT -> TCTGTGTTTTGTGAGTGTT
GTCTTCAATAAGGGGCGTG -> TCTTCAATAAGGGGCGTGC
GTGAACTCCGGCTACGACA -> TGAACTCCGGCTACGACAC
GTGAAGCGGATCATTCACA -> TGAAGCGGATCATTCACAT
GTGAAGTGGGGAACCTTCC -> TGAAGTGGGGAACCTTCCA
GTGAATCTGGAACGGATGC -> TGAATCTGGAACGGATGCC
GTGACTAACTTCCGCCTTA -> TGACTAACTTCCGCCTTAG
GTGAGGATTGGAAGATGAC -> TGAGGATTGGAAGATGACG
GTGAGGATTGGAAGCCGAG -> TGAGGATTGGAAGCCGAGA
GTGAGGATTGGAAGGACCT -> TGAGGATTGGAAGGACCTA
GTGAGGATTGGAAGTGGAA -> TGAGGATTGGAAGTGGAAG
GTGAGTGTTCTGTTGTACG -> TGAGTGTTCTGTTGTACGG
GTGATCGGACGAGGCTACT -> TGATCGGACGAGGCTACTG
GTGATCGGGCATATATGTA -> TGATCGGGCATATATGTAA
GTGCAAGTAGGACTCGATG -> TGCAAGTAGGACTCGATGC
GTGCAATCCTTAAATCCTT -> TGCAATCCTTAAATCCTTG
GTGCAGTCTGACGGACATG -> TGCAGTCTGACGGACATGA
GTGCATTAGCTATCCTCAG -> TGCATTAGCTATCCTCAGA
GTGCGAGCAGCAAGATTCT -> TGCGAGCAGCAAGATTCTT
GTGCGCGATATCATAGATC -> TGCGCGATATCATAGATCG
GTGCGGTTTCGTGGTCCGG -> TGCGGTTTCGTGGTCCGGC
GTGCGTGCGCGATATCATA -> TGCGTGCGCGATATCATAG
GTGCTATGGACGAAAGCGC -> TGCTATGGACGAAAGCGCC
GTGCTCGCCCCAACTGAAC -> TGCTCGCCCCAACTGAACA
GTGGAAGACAGGGTGGCTA -> TGGAAGACAGGGTGGCTAT
GTGGATAGACAGCTTGCTG -> TGGATAGACAGCTTGCTGG
GTGGCCCATGAGGTCCCCT -> TGGCCCATGAGGTCCCCTT
GTGGCCCTTACATGTACTC -> TGGCCCTTACATGTACTCC
GTGGCCTCGAAATACGTGG -> TGGCCTCGAAATACGTGGC
GTGGCTATAGATCCTGCAC -> TGGCTATAGATCCTGCACA,TGGCTATAGATCCTGCACC,TGGCTATAGATCCTGCACG,TGGCTATAGATCCTGCACT
GTGGCTTAGAGTGAACTCC -> TGGCTTAGAGTGAACTCCG
GTGGGGAACCTTCCACGGA -> TGGGGAACCTTCCACGGAC
GTGGTAGAAACGGATAGAA -> TGGTAGAAACGGATAGAAG
GTGGTCCGGCGAGAGACAT -> TGGTCCGGCGAGAGACATC
GTGGTTGCAACGTGGATAG -> TGGTTGCAACGTGGATAGA
GTGTAAGCGAGACCTCCTC -> TGTAAGCGAGACCTCCTCC
GTGTACGCACAACTAGAAA -> TGTACGCACAACTAGAAAC
GTGTAGAAGTCCACGTCGT -> TGTAGAAGTCCACGTCGTG
GTGTCCCGGTGAGGATTGG -> TGTCCCGGTGAGGATTGGA
GTGTGCGAGCAGCAAGATT -> TGTGCGAGCAGCAAGATTC
GTGTGCTATGGACGAAAGC -> TGTGCTATGGACGAAAGCG
GTGTGGCTTAGAGTGAACT -> TGTGGCTTAGAGTGAACTC
GTGTTAACGTGGCCCTTAC -> TGTTAACGTGGCCCTTACA
GTGTTCTGTTGTACGGAAC -> TGTTCTGTTGTACGGAACC
GTGTTTAGACGTCTGATAA -> TGTTTAGACGTCTGATAAC
GTGTTTTGTGAGTGTTCTG -> TGTTTTGTGAGTGTTCTGT
GTTAACGTGGCCCTTACAT -> TTAACGTGGCCCTTACATG
GTTACACAACGTCACCATC -> TTACACAACGTCACCATCT
GTTACAGCCGCCCTTAGAC -> TTACAGCCGCCCTTAGACG
GTTCAAATTGCTATCCACT -> TTCAAATTGCTATCCACTG
GTTCCAGGCCATGGACTCG -> TTCCAGGCCATGGACTCGA
GTTCCATCTCCTGACTAAA -> TTCCATCTCCTGACTAAAA
GTTCCGCTACCACAAGGAT -> TTCCGCTACCACAAGGATC
GTTCGCATACCGCTCCAGA -> TTCGCATACCGCTCCAGAC
GTTCGGGTCTACATCAAGT -> TTCGGGTCTACATCAAGTC
GTTCGTTACACAACGTCAC -> TTCGTTACACAACGTCACC
GTTCTGTTGTACGGAACCT -> TTCTGTTGTACGGAACCTT
GTTGAGCGTCCTACTTGAA -> TTGAGCGTCCTACTTGAAT
GTTGCAACGTGGATAGACA -> TTGCAACGTGGATAGACAG
GTTGCTGTCTTCAATAAGG -> TTGCTGTCTTCAATAAGGG
GTTGGTTGAGCGTCCTACT -> TTGGTTGAGCGTCCTACTT
GTTGTACAACTTCAACAAA -> TTGTACAACTTCAACAAAG
GTTGTACGGAACCTTGAGT -> TTGTACGGAACCTTGAGTC
GTTGTCAACTGTCAATCAT -> TTGTCAACTGTCAATCATT
GTTGTTTGTGTGCTATGGA -> TTGTTTGTGTGCTATGGAC
GTTTACCATCTCGCCGCCG -> TTTACCATCTCGCCGCCGG
GTTTAGACGTCTGATAACA -> TTTAGACGTCTGATAACAC
GTTTCCGTTTTACGTCTGT -> TTTCCGTTTTACGTCTGTG
GTTTCGTGGTCCGGCGAGA -> TTTCGTGGTCCGGCGAGAG
GTTTGAGTGTACGCACAAC -> TTTGAGTGTACGCACAACT
GTTTGATCGCTTTGCCCAG -> TTTGATCGCTTTGCCCAGG
GTTTGTGTGCTATGGACGA -> TTTGTGTGCTATGGACGAA
GTTTTACGTCTGTGTTTTG -> TTTTACGTCTGTGTTTTGT
GTTTTGTGAGTGTTCTGTT -> TTTTGTGAGTGTTCTGTTG
TAAAAATGTAGGACTCGAA -> AAAAATGTAGGACTCGAAG
TAAAATCTACGGGGGTAAA -> AAAATCTACGGGGGTAAAT
TAAACATAACGATGTTACA -> AAACATAACGATGTTACAG
TAAAGCTCATTAGTTGTAC -> AAAGCTCATTAGTTGTACA
TAAATAGTGGTAGAAACGG -> AAATAGTGGTAGAAACGGA
TAAATATAGGATAACACCT -> AAATATAGGATAACACCTG
TAAATCCTTGGGTCCGTTC -> AAATCCTTGGGTCCGTTCC
TAACACCTGACGCACTGCT -> AACACCTGACGCACTGCTA
TAACACTATGATTGGGAGA -> AACACTATGATTGGGAGAT
TAACATCACTCCGATAGGT -> AACATCACTCCGATAGGTG
TAACCGACAACTAAAGCTC -> AACCGACAACTAAAGCTCA
TAACGATGTTACAGCCGCC -> AACGATGTTACAGCCGCCC
TAACGTGGCCCTTACATGT -> AACGTGGCCCTTACATGTA
TAACTTCCGCCTTAGCACA -> AACTTCCGCCTTAGCACAG
TAAGCAGACACGAAAATGT -> AAGCAGACACGAAAATGTG
TAAGCGAGACCTCCTCCCG -> AAGCGAGACCTCCTCCCGA
TAAGGAAGATCACAGCAAG -> AAGGAAGATCACAGCAAGA
TAAGGGGCGTGCTCGCCCC -> AAGGGGCGTGCTCGCCCCA
TAAGGTGTTTAGACGTCTG -> AAGGTGTTTAGACGTCTGA
TAAGTCAGTAAATATAGGA -> AAGTCAGTAAATATAGGAT
TAAGTTTGAGTGTACGCAC -> AAGTTTGAGTGTACGCACA
TAATTTGGTGGCTATAGAT -> AATTTGGTGGCTATAGATC
TACAACTTCAACAAAGAGC -> ACAACTTCAACAAAGAGCG
TACACAACGTCACCATCTC -> ACACAACGTCACCATCTCG
TACACAATTTGCCACATCA -> ACACAATTTGCCACATCAT
TACACCGGGTGTAGAAGTC -> ACACCGGGTGTAGAAGTCC
TACAGCAACCCGGTGAGGA -> ACAGCAACCCGGTGAGGAT
TACAGCCGCCCTTAGACGT -> ACAGCCGCCCTTAGACGTG
TACATCAAGTCGATCGACA -> ACATCAAGTCGATCGACAG
TACATGCTACCCGAATGCC -> ACATGCTACCCGAATGCCC
TACATGTACTCCAACCAGC -> ACATGTACTCCAACCAGCT
TACCACAAGGATCGCCTCA -> ACCACAAGGATCGCCTCAT
TACCATCTCGCCGCCGGTA -> ACCATCTCGCCGCCGGTAC
TACCCGAATGCCCGGTGAG -> ACCCGAATGCCCGGTGAGG
TACCGCTCCAGACGGCAGC -> ACCGCTCCAGACGGCAGCC
TACCGGTTCGTTACACAAC -> ACCGGTTCGTTACACAACG
TACCTACGCGAAAGCGTAG -> ACCTACGCGAAAGCGTAGG
TACCTTCAGACGCCAGCTA -> ACCTTCAGACGCCAGCTAG
TACGACACCTCCCGTACCT -> ACGACACCTCCCGTACCTA
TACGCAATCATACGGTATG -> ACGCAATCATACGGTATGC
TACGCACAACTAGAAACTT -> ACGCACAACTAGAAACTTG
TACGCATGATGCGCAAATC -> ACGCATGATGCGCAAATCG
TACGCGAAAGCGTAGGATT -> ACGCGAAAGCGTAGGATTC
TACGCTAGACTGCAACTAT -> ACGCTAGACTGCAACTATC
TACGCTAGAGACCATTGTT -> ACGCTAGAGACCATTGTTT
TACGCTCCGTCCCGAGAGC -> ACGCTCCGTCCCGAGAGCG
TACGCTGCACTTAGTAGCC -> ACGCTGCACTTAGTAGCCT
TACGGAACCTTGAGTCGCT -> ACGGAACCTTGAGTCGCTC
TACGGGGGTAAATAGTGGT -> ACGGGGGTAAATAGTGGTA
TACGGTATGCTCTTCAGGC -> ACGGTATGCTCTTCAGGCC
TACGTCTGTGTTTTGTGAG -> ACGTCTGTGTTTTGTGAGT
TACGTGGCCCATGAGGTCC -> ACGTGGCCCATGAGGTCCC
TACGTTCCGCTACCACAAG -> ACGTTCCGCTACCACAAGG
TACTACACCGGGTGTAGAA -> ACTACACCGGGTGTAGAAG
TACTCCAACCAGCTCGACC -> ACTCCAACCAGCTCGACCT
TACTGCGAAGTACGTTCCG -> ACTGCGAAGTACGTTCCGC
TACTGCTGTGTGGCTTAGA -> ACTGCTGTGTGGCTTAGAG
TACTTGAATACTGCTGTGT -> ACTTGAATACTGCTGTGTG
TAGAAACGGATAGAAGTCG -> AGAAACGGATAGAAGTCGT
TAGAAACTTGCGGAGGCCT -> AGAAACTTGCGGAGGCCTA
TAGAAGTCCACGTCGTGAA -> AGAAGTCCACGTCGTGAAT
TAGAAGTCGTCGATTAGGA -> AGAAGTCGTCGATTAGGAA
TAGACAGCTTGCTGGCCGG -> AGACAGCTTGCTGGCCGGC
TAGACGTCTGATAACACTA -> AGACGTCTGATAACACTAT
TAGACGTGCATTAGCTATC -> AGACGTGCATTAGCTATCC
TAGACTGCAACTATCCGGC -> AGACTGCAACTATCCGGCA
TAGAGACCATTGTTTCCGT -> AGAGACCATTGTTTCCGTT
TAGAGTGAACTCCGGCTAC -> AGAGTGAACTCCGGCTACG
TAGATCCTGCACAGACTGA -> AGATCCTGCACAGACTGAC
TAGATCCTGCACCTCGACG -> AGATCCTGCACCTCGACGG
TAGATCCTGCACGGGGTTC -> AGATCCTGCACGGGGTTCG
TAGATCCTGCACTGTATAC -> AGATCCTGCACTGTATACG
TAGATCGTTCCAGGCCATG -> AGATCGTTCCAGGCCATGG
TAGCACAGACGGAATAGGC -> AGCACAGACGGAATAGGCT
TAGCACTGCCTCTAACCGA -> AGCACTGCCTCTAACCGAC
TAGCCAAGGTAAAATCTAC -> AGCCAAGGTAAAATCTACG
TAGCCTTTGCATCGGATCG -> AGCCTTTGCATCGGATCGT
TAGCGGGTTTACCATCTCG -> AGCGGGTTTACCATCTCGC
TAGCTATCCTCAGAGTTCG -> AGCTATCCTCAGAGTTCGG
TAGGAATAGTTTGATCGCT -> AGGAATAGTTTGATCGCTT
TAGGACTCGAAGGCACTGG -> AGGACTCGAAGGCACTGGC
TAGGACTCGATGCCTATGA -> AGGACTCGATGCCTATGAT
TAGGATAACACCTGACGCA -> AGGATAACACCTGACGCAC
TAGGATTCCTGGACGATGC -> AGGATTCCTGGACGATGCC
TAGGCCCCCGTGCGGTTTC -> AGGCCCCCGTGCGGTTTCG
TAGGCTTAGGGCGTGTTAA -> AGGCTTAGGGCGTGTTAAC
TAGGGCAGGAGGTGACTAA -> AGGGCAGGAGGTGACTAAC
TAGGGCGTGTTAACGTGGC -> AGGGCGTGTTAACGTGGCC
TAGGTCACCTGATCTCCCG -> AGGTCACCTGATCTCCCGA
TAGGTGAAGTGGGGAACCT -> AGGTGAAGTGGGGAACCTT
TAGGTGGCTATAGATCCTG -> AGGTGGCTATAGATCCTGC
TAGTAGCCTTTGCATCGGA -> AGTAGCCTTTGCATCGGAT
TAGTAGTGTGCGAGCAGCA -> AGTAGTGTGCGAGCAGCAA
TAGTATGACAGCTCGGTCC -> AGTATGACAGCTCGGTCCT
TAGTCACCGTGCGTGCGCG -> AGTCACCGTGCGTGCGCGA
TAGTGGTAGAAACGGATAG -> AGTGGTAGAAACGGATAGA
TAGTGTGCGAGCAGCAAGA -> AGTGTGCGAGCAGCAAGAT
TAGTTGGTTGAGCGTCCTA -> AGTTGGTTGAGCGTCCTAC
TAGTTGTACAACTTCAACA -> AGTTGTACAACTTCAACAA
TAGTTTGATCGCTTTGCCC -> AGTTTGATCGCTTTGCCCA
TATACGCTGCACTTAGTAG -> ATACGCTGCACTTAGTAGC
TATAGATCCTGCACAGACT -> ATAGATCCTGCACAGACTG
TATAGATCCTGCACCTCGA -> ATAGATCCTGCACCTCGAC
TATAGATCCTGCACGGGGT -> ATAGATCCTGCACGGGGTT
TATAGATCCTGCACTGTAT -> ATAGATCCTGCACTGTATA
TATAGGATAACACCTGACG -> ATAGGATAACACCTGACGC
TATATGGGTGATCGGACGA -> ATATGGGTGATCGGACGAG
TATATGTAAGCAGACACGA -> ATATGTAAGCAGACACGAA
TATCAACTCATAGGGCAGG -> ATCAACTCATAGGGCAGGA
TATCATAGATCGTTCCAGG -> ATCATAGATCGTTCCAGGC
TATCCACTGGGTACATGCT -> ATCCACTGGGTACATGCTA
TATCCGGCAGGCACTTCAC -> ATCCGGCAGGCACTTCACA
TATCCTCAGAGTTCGGGTC -> ATCCTCAGAGTTCGGGTCT
TATCGTGGCTATAGATCCT -> ATCGTGGCTATAGATCCTG
TATCTGTGCAGTCTGACGG -> ATCTGTGCAGTCTGACGGA
TATGAACTAGTATGACAGC -> ATGAACTAGTATGACAGCT
TATGAAGCGTACACAATTT -> ATGAAGCGTACACAATTTG
TATGACAGCTCGGTCCTCG -> ATGACAGCTCGGTCCTCGT
TATGATGGCCCCGACAGCT -> ATGATGGCCCCGACAGCTT
TATGATTGGGAGATCGACT -> ATGATTGGGAGATCGACTT
TATGCTCTTCAGGCCAAGA -> ATGCTCTTCAGGCCAAGAT
TATGGACGAAAGCGCCCCT -> ATGGACGAAAGCGCCCCTG
TATGGGTGATCGGACGAGG -> ATGGGTGATCGGACGAGGC
TATGTAAGCAGACACGAAA -> ATGTAAGCAGACACGAAAA
TCAAAGGTGGTTGCAACGT -> CAAAGGTGGTTGCAACGTG
TCAAATTGCTATCCACTGG -> CAAATTGCTATCCACTGGG
TCAACAAAGAGCGCAGGCC -> CAACAAAGAGCGCAGGCCG
TCAACTCATAGGGCAGGAG -> CAACTCATAGGGCAGGAGG
TCAACTGTCAATCATTTAG -> CAACTGTCAATCATTTAGT
TCAAGTCGATCGACAGGTT -> CAAGTCGATCGACAGGTTG
TCAATAAGGGGCGTGCTCG -> CAATAAGGGGCGTGCTCGC
TCAATCATTTAGTCACCGT -> CAATCATTTAGTCACCGTG
TCAATGGTCGAGCCTGGAG -> CAATGGTCGAGCCTGGAGA
TCACACATTGGACACTCAA -> CACACATTGGACACTCAAA
TCACAGCAAGACCCATACG -> CACAGCAAGACCCATACGC
TCACATACCTTCAGACGCC -> CACATACCTTCAGACGCCA
TCACCATCTCGAAACCAGC -> CACCATCTCGAAACCAGCA
TCACCGTGCGTGCGCGATA -> CACCGTGCGTGCGCGATAT
TCACCTGATCTCCCGACCT -> CACCTGATCTCCCGACCTA
TCACTCCGATAGGTGAAGT -> CACTCCGATAGGTGAAGTG
TCAGACGCCAGCTAGCCAA -> CAGACGCCAGCTAGCCAAG
TCAGAGTTCGGGTCTACAT -> CAGAGTTCGGGTCTACATC
TCAGGCCAAGATAAGGTGT -> CAGGCCAAGATAAGGTGTT
TCAGTAAATATAGGATAAC -> CAGTAAATATAGGATAACA
TCATAAACATAACGATGTT -> CATAAACATAACGATGTTA
TCATACGGTATGCTCTTCA -> CATACGGTATGCTCTTCAG
TCATAGATCGTTCCAGGCC -> CATAGATCGTTCCAGGCCA
TCATAGGGCAGGAGGTGAC -> CATAGGGCAGGAGGTGACT
TCATCGGGCCATACGCTAG -> CATCGGGCCATACGCTAGA
TCATGAGACGGAAGAACAA -> CATGAGACGGAAGAACAAA
TCATTAGTTGTACAACTTC -> CATTAGTTGTACAACTTCA
TCATTCACATACCTTCAGA -> CATTCACATACCTTCAGAC
TCATTTAGTCACCGTGCGT -> CATTTAGTCACCGTGCGTG
TCCAACCAGCTCGACCTAG -> CCAACCAGCTCGACCTAGT
TCCACCGTAGCACTGCCTC -> CCACCGTAGCACTGCCTCT
TCCACGGACGGAGAAAGTG -> CCACGGACGGAGAAAGTGG
TCCACGTCGTGAATCTGGA -> CCACGTCGTGAATCTGGAA
TCCACTGGGTACATGCTAC -> CCACTGGGTACATGCTACC
TCCAGACGGCAGCCCCGGT -> CCAGACGGCAGCCCCGGTG
TCCAGGCCATGGACTCGAT -> CCAGGCCATGGACTCGATG
TCCAGTTGTTTGTGTGCTA -> CCAGTTGTTTGTGTGCTAT
TCCATCTCCCCTTCATGAG -> CCATCTCCCCTTCATGAGA
TCCATCTCCTGACTAAAAA -> CCATCTCCTGACTAAAAAT
TCCCACGTCGCTGGTATGA -> CCCACGTCGCTGGTATGAA
TCCCCTTATATGGGTGATC -> CCCCTTATATGGGTGATCG
TCCCCTTCATGAGACGGAA -> CCCCTTCATGAGACGGAAG
TCCCGAATTTACCGGTTCG -> CCCGAATTTACCGGTTCGT
TCCCGACCTACGCTCCGTC -> CCCGACCTACGCTCCGTCC
TCCCGAGAGCGTAGCGGGT -> CCCGAGAGCGTAGCGGGTT
TCCCGGTGAGGATTGGAAG -> CCCGGTGAGGATTGGAAGT
TCCCGTACCTACGCGAAAG -> CCCGTACCTACGCGAAAGC
TCCGATAGGTGAAGTGGGG -> CCGATAGGTGAAGTGGGGA
TCCGCCTTAGCACAGACGG -> CCGCCTTAGCACAGACGGA
TCCGCTACCACAAGGATCG -> CCGCTACCACAAGGATCGC
TCCGGCAGGCACTTCACAC -> CCGGCAGGCACTTCACACA
TCCGGCGAGAGACATCTCC -> CCGGCGAGAGACATCTCCA
TCCGGCTACGACACCTCCC -> CCGGCTACGACACCTCCCG
TCCGGTGCAATCCTTAAAT -> CCGGTGCAATCCTTAAATC
TCCGTCCCGAGAGCGTAGC -> CCGTCCCGAGAGCGTAGCG
TCCGTTCCATCTCCTGACT -> CCGTTCCATCTCCTGACTA
TCCGTTTTACGTCTGTGTT -> CCGTTTTACGTCTGTGTTT
TCCTACTTGAATACTGCTG -> CCTACTTGAATACTGCTGT
TCCTAGGTCACCTGATCTC -> CCTAGGTCACCTGATCTCC
TCCTCAGAGTTCGGGTCTA -> CCTCAGAGTTCGGGTCTAC
TCCTCCCGAATTTACCGGT -> CCTCCCGAATTTACCGGTT
TCCTCGTCTGGGAAGGATG -> CCTCGTCTGGGAAGGATGC
TCCTGACTAAAAATGTAGG -> CCTGACTAAAAATGTAGGA
TCCTGCACAGACTGACCAC -> CCTGCACAGACTGACCACC
TCCTGCACCTCGACGGCAG -> CCTGCACCTCGACGGCAGA
TCCTGCACGGGGTTCGCAT -> CCTGCACGGGGTTCGCATA
TCCTGCACTGTATACGCTG -> CCTGCACTGTATACGCTGC
TCCTGGACGATGCCGACTC -> CCTGGACGATGCCGACTCG
TCCTTAAATCCTTGGGTCC -> CCTTAAATCCTTGGGTCCG
TCCTTGGGTCCGTTCCATC -> CCTTGGGTCCGTTCCATCT
TCGAAACCAGCAAGCTGGT -> CGAAACCAGCAAGCTGGTT
TCGAAATACGTGGCCCATG -> CGAAATACGTGGCCCATGA
TCGAAGGCACTGGCTGCAC -> CGAAGGCACTGGCTGCACT
TCGACAGGTTGCTGTCTTC -> CGACAGGTTGCTGTCTTCA
TCGACCCATCTTTCAATGG -> CGACCCATCTTTCAATGGT
TCGACCTAGTTGGTTGAGC -> CGACCTAGTTGGTTGAGCG
TCGACGGCAGATGGCACCA -> CGACGGCAGATGGCACCAA
TCGACTTGATGGGTGCAAG -> CGACTTGATGGGTGCAAGT
TCGAGCCTGGAGAGAGTAC -> CGAGCCTGGAGAGAGTACA
TCGATCGACAGGTTGCTGT -> CGATCGACAGGTTGCTGTC
TCGATGCCTATGATGGCCC -> CGATGCCTATGATGGCCCC
TCGATGTCGACCCATCTTT -> CGATGTCGACCCATCTTTC
TCGATTAGGAATAGTTTGA -> CGATTAGGAATAGTTTGAT
TCGCACCCTGCGTGTCCCG -> CGCACCCTGCGTGTCCCGG
TCGCATACCGCTCCAGACG -> CGCATACCGCTCCAGACGG
TCGCCCCAACTGAACACGG -> CGCCCCAACTGAACACGGG
TCGCCGCCGGTACGCAATC -> CGCCGCCGGTACGCAATCA
TCGCCGCTACGCTAGACTG -> CGCCGCTACGCTAGACTGC
TCGCCTCATAAACATAACG -> CGCCTCATAAACATAACGA
TCGCTCGTAAGTCAGTAAA -> CGCTCGTAAGTCAGTAAAT
TCGCTGGTATGAAGCGTAC -> CGCTGGTATGAAGCGTACA
TCGCTTTGCCCAGGGAGAA -> CGCTTTGCCCAGGGAGAAC
TCGGACGAGGCTACTGCGA -> CGGACGAGGCTACTGCGAA
TCGGATCGTCCACCGTAGC -> CGGATCGTCCACCGTAGCA
TCGGCTCCCACGTCGCTGG -> CGGCTCCCACGTCGCTGGT
TCGGGCATATATGTAAGCA -> CGGGCATATATGTAAGCAG
TCGGGCCATACGCTAGAGA -> CGGGCCATACGCTAGAGAC
TCGGGTCTACATCAAGTCG -> CGGGTCTACATCAAGTCGA
TCGGTCCTCGTCTGGGAAG -> CGGTCCTCGTCTGGGAAGG
TCGTAAGTCAGTAAATATA -> CGTAAGTCAGTAAATATAG
TCGTCCACCGTAGCACTGC -> CGTCCACCGTAGCACTGCC
TCGTCGATTAGGAATAGTT -> CGTCGATTAGGAATAGTTT
TCGTCTGGGAAGGATGCGA -> CGTCTGGGAAGGATGCGAG
TCGTGAATCTGGAACGGAT -> CGTGAATCTGGAACGGATG
TCGTGATCGGGCATATATG -> CGTGATCGGGCATATATGT
TCGTGGCTATAGATCCTGC -> CGTGGCTATAGATCCTGCA
TCGTGGTCCGGCGAGAGAC -> CGTGGTCCGGCGAGAGACA
TCGTTACACAACGTCACCA -> CGTTACACAACGTCACCAT
TCGTTCCAGGCCATGGACT -> CGTTCCAGGCCATGGACTC
TCTAACCGACAACTAAAGC -> CTAACCGACAACTAAAGCT
TCTACATCAAGTCGATCGA -> CTACATCAAGTCGATCGAC
TCTACGGGGGTAAATAGTG -> CTACGGGGGTAAATAGTGG
TCTCCATCTCCCCTTCATG -> CTCCATCTCCCCTTCATGA
TCTCCCCTTCATGAGACGG -> CTCCCCTTCATGAGACGGA
TCTCCCGACCTACGCTCCG -> CTCCCGACCTACGCTCCGT
TCTCCTGACTAAAAATGTA -> CTCCTGACTAAAAATGTAG
TCTCGAAACCAGCAAGCTG -> CTCGAAACCAGCAAGCTGG
TCTCGCCGCCGGTACGCAA -> CTCGCCGCCGGTACGCAAT
TCTGACGGACATGACGGCC -> CTGACGGACATGACGGCCT
TCTGATAACACTATGATTG -> CTGATAACACTATGATTGG
TCTGGAACGGATGCCATCG -> CTGGAACGGATGCCATCGG
TCTGGGAAGGATGCGAGTT -> CTGGGAAGGATGCGAGTTC
TCTGTGCAGTCTGACGGAC -> CTGTGCAGTCTGACGGACA
TCTGTGTTTTGTGAGTGTT -> CTGTGTTTTGTGAGTGTTC
TCTGTTGTACGGAACCTTG -> CTGTTGTACGGAACCTTGA
TCTTCAATAAGGGGCGTGC -> CTTCAATAAGGGGCGTGCT
TCTTCAGGCCAAGATAAGG -> CTTCAGGCCAAGATAAGGT
TCTTGTCCAGTTGTTTGTG -> CTTGTCCAGTTGTTTGTGT
TCTTTCAATGGTCGAGCCT -> CTTTCAATGGTCGAGCCTG
TGAACTAGTATGACAGCTC -> GAACTAGTATGACAGCTCG
TGAACTCCGGCTACGACAC -> GAACTCCGGCTACGACACC
TGAAGCGGATCATTCACAT -> GAAGCGGATCATTCACATA
TGAAGCGTACACAATTTGC -> GAAGCGTACACAATTTGCC
TGAAGTGGGGAACCTTCCA -> GAAGTGGGGAACCTTCCAC
TGAATACTGCTGTGTGGCT -> GAATACTGCTGTGTGGCTT
TGAATCTGGAACGGATGCC -> GAATCTGGAACGGATGCCA
TGACAGCTCGGTCCTCGTC -> GACAGCTCGGTCCTCGTCT
TGACCACCGTATCAACTCA -> GACCACCGTATCAACTCAT
TGACGATATCGTGGCTATA -> GACGATATCGTGGCTATAG
TGACGCACTGCTATCTGTG -> GACGCACTGCTATCTGTGC
TGACGGAAACACCAAGGTA -> GACGGAAACACCAAGGTAA
TGACGGACATGACGGCCTA -> GACGGACATGACGGCCTAA
TGACGGCCTAAGGAAGATC -> GACGGCCTAAGGAAGATCA
TGACTAAAAATGTAGGACT -> GACTAAAAATGTAGGACTC
TGACTAACTTCCGCCTTAG -> GACTAACTTCCGCCTTAGC
TGAGACGGAAGAACAAACA -> GAGACGGAAGAACAAACAC
TGAGCGTCCTACTTGAATA -> GAGCGTCCTACTTGAATAC
TGAGGATTGGAAGATGACG -> GAGGATTGGAAGATGACGA
TGAGGATTGGAAGCCGAGA -> GAGGATTGGAAGCCGAGAG
TGAGGATTGGAAGGACCTA -> GAGGATTGGAAGGACCTAA
TGAGGATTGGAAGTGGAAG -> GAGGATTGGAAGTGGAAGA
TGAGGTCCCCTTATATGGG -> GAGGTCCCCTTATATGGGT
TGAGTCGCTCGTAAGTCAG -> GAGTCGCTCGTAAGTCAGT
TGAGTGTACGCACAACTAG -> GAGTGTACGCACAACTAGA
TGAGTGTTCTGTTGTACGG -> GAGTGTTCTGTTGTACGGA
TGATAACACTATGATTGGG -> GATAACACTATGATTGGGA
TGATCGCTTTGCCCAGGGA -> GATCGCTTTGCCCAGGGAG
TGATCGGACGAGGCTACTG -> GATCGGACGAGGCTACTGC
TGATCGGGCATATATGTAA -> GATCGGGCATATATGTAAG
TGATCTCCCGACCTACGCT -> GATCTCCCGACCTACGCTC
TGATGCGCAAATCGTGATC -> GATGCGCAAATCGTGATCG
TGATGGCCCCGACAGCTTT -> GATGGCCCCGACAGCTTTG
TGATGGGTGCAAGTAGGAC -> GATGGGTGCAAGTAGGACT
TGATTGGGAGATCGACTTG -> GATTGGGAGATCGACTTGA
TGCAACGTGGATAGACAGC -> GCAACGTGGATAGACAGCT
TGCAACTATCCGGCAGGCA -> GCAACTATCCGGCAGGCAC
TGCAAGGAGTGAAGCGGAT -> GCAAGGAGTGAAGCGGATC
TGCAAGTAGGACTCGATGC -> GCAAGTAGGACTCGATGCC
TGCAATCCTTAAATCCTTG -> GCAATCCTTAAATCCTTGG
TGCACAACTGCAAGGAGTG -> GCACAACTGCAAGGAGTGA
TGCACAGACTGACCACCGT -> GCACAGACTGACCACCGTA
TGCACCTCGACGGCAGATG -> GCACCTCGACGGCAGATGG
TGCACGGGGTTCGCATACC -> GCACGGGGTTCGCATACCG
TGCACTGTATACGCTGCAC -> GCACTGTATACGCTGCACT
TGCACTTAGTAGCCTTTGC -> GCACTTAGTAGCCTTTGCA
TGCACTTTCGCACCCTGCG -> GCACTTTCGCACCCTGCGT
TGCAGTCTGACGGACATGA -> GCAGTCTGACGGACATGAC
TGCATCGGATCGTCCACCG -> GCATCGGATCGTCCACCGT
TGCATTAGCTATCCTCAGA -> GCATTAGCTATCCTCAGAG
TGCCACATCATCGGGCCAT -> GCCACATCATCGGGCCATA
TGCCATCGGCTCCCACGTC -> GCCATCGGCTCCCACGTCG
TGCCCAGGGAGAACTAGGC -> GCCCAGGGAGAACTAGGCC
TGCCCGGTGAGGATTGGAA -> GCCCGGTGAGGATTGGAAG
TGCCGACTCGCCGCTACGC -> GCCGACTCGCCGCTACGCT
TGCCTATGATGGCCCCGAC -> GCCTATGATGGCCCCGACA
TGCCTCTAACCGACAACTA -> GCCTCTAACCGACAACTAA
TGCGAAGTACGTTCCGCTA -> GCGAAGTACGTTCCGCTAC
TGCGAGCAGCAAGATTCTT -> GCGAGCAGCAAGATTCTTG
TGCGAGTTCAAATTGCTAT -> GCGAGTTCAAATTGCTATC
TGCGCAAATCGTGATCGGG -> GCGCAAATCGTGATCGGGC
TGCGCGATATCATAGATCG -> GCGCGATATCATAGATCGT
TGCGGAGGCCTATGAACTA -> GCGGAGGCCTATGAACTAG
TGCGGTTTCGTGGTCCGGC -> GCGGTTTCGTGGTCCGGCG
TGCGTACTACACCGGGTGT -> GCGTACTACACCGGGTGTA
TGCGTGCGCGATATCATAG -> GCGTGCGCGATATCATAGA
TGCGTGTCCCGGTGAGGAT -> GCGTGTCCCGGTGAGGATT
TGCTACCCGAATGCCCGGT -> GCTACCCGAATGCCCGGTG
TGCTATCCACTGGGTACAT -> GCTATCCACTGGGTACATG
TGCTATCTGTGCAGTCTGA -> GCTATCTGTGCAGTCTGAC
TGCTATGGACGAAAGCGCC -> GCTATGGACGAAAGCGCCC
TGCTCGCCCCAACTGAACA -> GCTCGCCCCAACTGAACAC
TGCTCTTCAGGCCAAGATA -> GCTCTTCAGGCCAAGATAA
TGCTGGCCGGCTAGTAGTG -> GCTGGCCGGCTAGTAGTGT
TGCTGTCTTCAATAAGGGG -> GCTGTCTTCAATAAGGGGC
TGCTGTGTGGCTTAGAGTG -> GCTGTGTGGCTTAGAGTGA
TGGAACGGATGCCATCGGC -> GGAACGGATGCCATCGGCT
TGGAAGACAGGGTGGCTAT -> GGAAGACAGGGTGGCTATA
TGGAAGATGACGATATCGT -> GGAAGATGACGATATCGTG
TGGAAGCCGAGAGGTAGGT -> GGAAGCCGAGAGGTAGGTG
TGGAAGGACCTAATTTGGT -> GGAAGGACCTAATTTGGTG
TGGAAGTGGAAGACAGGGT -> GGAAGTGGAAGACAGGGTG
TGGACACTCAAAGGTGGTT -> GGACACTCAAAGGTGGTTG
TGGACGAAAGCGCCCCTGT -> GGACGAAAGCGCCCCTGTA
TGGACGATGCCGACTCGCC -> GGACGATGCCGACTCGCCG
TGGACTCGATGTCGACCCA -> GGACTCGATGTCGACCCAT
TGGAGAGAGTACAGCAACC -> GGAGAGAGTACAGCAACCC
TGGATAGACAGCTTGCTGG -> GGATAGACAGCTTGCTGGC
TGGCACCAAGGCCTCCGGT -> GGCACCAAGGCCTCCGGTG
TGGCCCATGAGGTCCCCTT -> GGCCCATGAGGTCCCCTTA
TGGCCCCGACAGCTTTGCG -> GGCCCCGACAGCTTTGCGT
TGGCCCTTACATGTACTCC -> GGCCCTTACATGTACTCCA
TGGCCGGCTAGTAGTGTGC -> GGCCGGCTAGTAGTGTGCG
TGGCCTCGAAATACGTGGC -> GGCCTCGAAATACGTGGCC
TGGCTATAGATCCTGCACA -> GGCTATAGATCCTGCACAG
TGGCTATAGATCCTGCACC -> GGCTATAGATCCTGCACCT
TGGCTATAGATCCTGCACG -> GGCTATAGATCCTGCACGG
TGGCTATAGATCCTGCACT -> GGCTATAGATCCTGCACTG
TGGCTGCACTTTCGCACCC -> GGCTGCACTTTCGCACCCT
TGGCTTAGAGTGAACTCCG -> GGCTTAGAGTGAACTCCGG
TGGGAAGGATGCGAGTTCA -> GGGAAGGATGCGAGTTCAA
TGGGAGATCGACTTGATGG -> GGGAGATCGACTTGATGGG
TGGGGAACCTTCCACGGAC -> GGGGAACCTTCCACGGACG
TGGGTACATGCTACCCGAA -> GGGTACATGCTACCCGAAT
TGGGTCCGTTCCATCTCCT -> GGGTCCGTTCCATCTCCTG
TGGGTGATCGGACGAGGCT -> GGGTGATCGGACGAGGCTA
TGGGTGCAAGTAGGACTCG -> GGGTGCAAGTAGGACTCGA
TGGTAGAAACGGATAGAAG -> GGTAGAAACGGATAGAAGT
TGGTATGAAGCGTACACAA -> GGTATGAAGCGTACACAAT
TGGTCCGGCGAGAGACATC -> GGTCCGGCGAGAGACATCT
TGGTCGAGCCTGGAGAGAG -> GGTCGAGCCTGGAGAGAGT
TGGTGGCTATAGATCCTGC -> GGTGGCTATAGATCCTGCA
TGGTTGAGCGTCCTACTTG -> GGTTGAGCGTCCTACTTGA
TGGTTGCAACGTGGATAGA -> GGTTGCAACGTGGATAGAC
TGGTTGTCAACTGTCAATC -> GGTTGTCAACTGTCAATCA
TGTAAGCAGACACGAAAAT -> GTAAGCAGACACGAAAATG
TGTAAGCGAGACCTCCTCC -> GTAAGCGAGACCTCCTCCC
TGTAAGTTTGAGTGTACGC -> GTAAGTTTGAGTGTACGCA
TGTACAACTTCAACAAAGA -> GTACAACTTCAACAAAGAG
TGTACGCACAACTAGAAAC -> GTACGCACAACTAGAAACT
TGTACGGAACCTTGAGTCG -> GTACGGAACCTTGAGTCGC
TGTACTCCAACCAGCTCGA -> GTACTCCAACCAGCTCGAC
TGTAGAAGTCCACGTCGTG -> GTAGAAGTCCACGTCGTGA
TGTAGGACTCGAAGGCACT -> GTAGGACTCGAAGGCACTG
TGTATACGCTGCACTTAGT -> GTATACGCTGCACTTAGTA
TGTCAACTGTCAATCATTT -> GTCAACTGTCAATCATTTA
TGTCAATCATTTAGTCACC -> GTCAATCATTTAGTCACCG
TGTCCAGTTGTTTGTGTGC -> GTCCAGTTGTTTGTGTGCT
TGTCCCGGTGAGGATTGGA -> GTCCCGGTGAGGATTGGAA
TGTCGACCCATCTTTCAAT -> GTCGACCCATCTTTCAATG
TGTCTTCAATAAGGGGCGT -> GTCTTCAATAAGGGGCGTG
TGTGAGTGTTCTGTTGTAC -> GTGAGTGTTCTGTTGTACG
TGTGCAGTCTGACGGACAT -> GTGCAGTCTGACGGACATG
TGTGCGAGCAGCAAGATTC -> GTGCGAGCAGCAAGATTCT
TGTGCTATGGACGAAAGCG -> GTGCTATGGACGAAAGCGC
TGTGGCTTAGAGTGAACTC -> GTGGCTTAGAGTGAACTCC
TGTGTAAGCGAGACCTCCT -> GTGTAAGCGAGACCTCCTC
TGTGTGCTATGGACGAAAG -> GTGTGCTATGGACGAAAGC
TGTGTGGCTTAGAGTGAAC -> GTGTGGCTTAGAGTGAACT
TGTGTTTTGTGAGTGTTCT -> GTGTTTTGTGAGTGTTCTG
TGTTAACGTGGCCCTTACA -> GTTAACGTGGCCCTTACAT
TGTTACAGCCGCCCTTAGA -> GTTACAGCCGCCCTTAGAC
TGTTCTGTTGTACGGAACC -> GTTCTGTTGTACGGAACCT
TGTTGTACGGAACCTTGAG -> GTTGTACGGAACCTTGAGT
TGTTTAGACGTCTGATAAC -> GTTTAGACGTCTGATAACA
TGTTTCCGTTTTACGTCTG -> GTTTCCGTTTTACGTCTGT
TGTTTGTGTGCTATGGACG -> GTTTGTGTGCTATGGACGA
TGTTTTGTGAGTGTTCTGT -> GTTTTGTGAGTGTTCTGTT
TTAAATCCTTGGGTCCGTT -> TAAATCCTTGGGTCCGTTC
TTAACGTGGCCCTTACATG -> TAACGTGGCCCTTACATGT
TTACACAACGTCACCATCT -> TACACAACGTCACCATCTC
TTACAGCCGCCCTTAGACG -> TACAGCCGCCCTTAGACGT
TTACATGTACTCCAACCAG -> TACATGTACTCCAACCAGC
TTACCATCTCGCCGCCGGT -> TACCATCTCGCCGCCGGTA
TTACCGGTTCGTTACACAA -> TACCGGTTCGTTACACAAC
TTACGTCTGTGTTTTGTGA -> TACGTCTGTGTTTTGTGAG
TTAGACGTCTGATAACACT -> TAGACGTCTGATAACACTA
TTAGACGTGCATTAGCTAT -> TAGACGTGCATTAGCTATC
TTAGAGTGAACTCCGGCTA -> TAGAGTGAACTCCGGCTAC
TTAGCACAGACGGAATAGG -> TAGCACAGACGGAATAGGC
TTAGCTATCCTCAGAGTTC -> TAGCTATCCTCAGAGTTCG
TTAGGAATAGTTTGATCGC -> TAGGAATAGTTTGATCGCT
TTAGGGCGTGTTAACGTGG -> TAGGGCGTGTTAACGTGGC
TTAGTAGCCTTTGCATCGG -> TAGTAGCCTTTGCATCGGA
TTAGTCACCGTGCGTGCGC -> TAGTCACCGTGCGTGCGCG
TTAGTTGTACAACTTCAAC -> TAGTTGTACAACTTCAACA
TTATATGGGTGATCGGACG -> TATATGGGTGATCGGACGA
TTCAAATTGCTATCCACTG -> TCAAATTGCTATCCACTGG
TTCAACAAAGAGCGCAGGC -> TCAACAAAGAGCGCAGGCC
TTCAATAAGGGGCGTGCTC -> TCAATAAGGGGCGTGCTCG
TTCAATGGTCGAGCCTGGA -> TCAATGGTCGAGCCTGGAG
TTCACACATTGGACACTCA -> TCACACATTGGACACTCAA
TTCACATACCTTCAGACGC -> TCACATACCTTCAGACGCC
TTCAGACGCCAGCTAGCCA -> TCAGACGCCAGCTAGCCAA
TTCAGGCCAAGATAAGGTG -> TCAGGCCAAGATAAGGTGT
TTCATGAGACGGAAGAACA -> TCATGAGACGGAAGAACAA
TTCCACGGACGGAGAAAGT -> TCCACGGACGGAGAAAGTG
TTCCAGGCCATGGACTCGA -> TCCAGGCCATGGACTCGAT
TTCCATCTCCTGACTAAAA -> TCCATCTCCTGACTAAAAA
TTCCGCCTTAGCACAGACG -> TCCGCCTTAGCACAGACGG
TTCCGCTACCACAAGGATC -> TCCGCTACCACAAGGATCG
TTCCGTTTTACGTCTGTGT -> TCCGTTTTACGTCTGTGTT
TTCCTGGACGATGCCGACT -> TCCTGGACGATGCCGACTC
TTCGCACCCTGCGTGTCCC -> TCGCACCCTGCGTGTCCCG
TTCGCATACCGCTCCAGAC -> TCGCATACCGCTCCAGACG
TTCGGGTCTACATCAAGTC -> TCGGGTCTACATCAAGTCG
TTCGTGGTCCGGCGAGAGA -> TCGTGGTCCGGCGAGAGAC
TTCGTTACACAACGTCACC -> TCGTTACACAACGTCACCA
TTCTGTTGTACGGAACCTT -> TCTGTTGTACGGAACCTTG
TTCTTGTCCAGTTGTTTGT -> TCTTGTCCAGTTGTTTGTG
TTGAATACTGCTGTGTGGC -> TGAATACTGCTGTGTGGCT
TTGACGGAAACACCAAGGT -> TGACGGAAACACCAAGGTA
TTGAGCGTCCTACTTGAAT -> TGAGCGTCCTACTTGAATA
TTGAGTCGCTCGTAAGTCA -> TGAGTCGCTCGTAAGTCAG
TTGAGTGTACGCACAACTA -> TGAGTGTACGCACAACTAG
TTGATCGCTTTGCCCAGGG -> TGATCGCTTTGCCCAGGGA
TTGATGGGTGCAAGTAGGA -> TGATGGGTGCAAGTAGGAC
TTGCAACGTGGATAGACAG -> TGCAACGTGGATAGACAGC
TTGCACAACTGCAAGGAGT -> TGCACAACTGCAAGGAGTG
TTGCATCGGATCGTCCACC -> TGCATCGGATCGTCCACCG
TTGCCACATCATCGGGCCA -> TGCCACATCATCGGGCCAT
TTGCCCAGGGAGAACTAGG -> TGCCCAGGGAGAACTAGGC
TTGCGGAGGCCTATGAACT -> TGCGGAGGCCTATGAACTA
TTGCGTACTACACCGGGTG -> TGCGTACTACACCGGGTGT
TTGCTATCCACTGGGTACA -> TGCTATCCACTGGGTACAT
TTGCTGGCCGGCTAGTAGT -> TGCTGGCCGGCTAGTAGTG
TTGCTGTCTTCAATAAGGG -> TGCTGTCTTCAATAAGGGG
TTGGAAGATGACGATATCG -> TGGAAGATGACGATATCGT
TTGGAAGCCGAGAGGTAGG -> TGGAAGCCGAGAGGTAGGT
TTGGAAGGACCTAATTTGG -> TGGAAGGACCTAATTTGGT
TTGGAAGTGGAAGACAGGG -> TGGAAGTGGAAGACAGGGT
TTGGACACTCAAAGGTGGT -> TGGACACTCAAAGGTGGTT
TTGGGAGATCGACTTGATG -> TGGGAGATCGACTTGATGG
TTGGGTCCGTTCCATCTCC -> TGGGTCCGTTCCATCTCCT
TTGGTGGCTATAGATCCTG -> TGGTGGCTATAGATCCTGC
TTGGTTGAGCGTCCTACTT -> TGGTTGAGCGTCCTACTTG
TTGTACAACTTCAACAAAG -> TGTACAACTTCAACAAAGA
TTGTACGGAACCTTGAGTC -> TGTACGGAACCTTGAGTCG
TTGTCAACTGTCAATCATT -> TGTCAACTGTCAATCATTT
TTGTCCAGTTGTTTGTGTG -> TGTCCAGTTGTTTGTGTGC
TTGTGAGTGTTCTGTTGTA -> TGTGAGTGTTCTGTTGTAC
TTGTGTGCTATGGACGAAA -> TGTGTGCTATGGACGAAAG
TTGTTTCCGTTTTACGTCT -> TGTTTCCGTTTTACGTCTG
TTGTTTGTGTGCTATGGAC -> TGTTTGTGTGCTATGGACG
TTTACCATCTCGCCGCCGG -> TTACCATCTCGCCGCCGGT
TTTACCGGTTCGTTACACA -> TTACCGGTTCGTTACACAA
TTTACGTCTGTGTTTTGTG -> TTACGTCTGTGTTTTGTGA
TTTAGACGTCTGATAACAC -> TTAGACGTCTGATAACACT
TTTAGTCACCGTGCGTGCG -> TTAGTCACCGTGCGTGCGC
TTTCAATGGTCGAGCCTGG -> TTCAATGGTCGAGCCTGGA
TTTCCGTTTTACGTCTGTG -> TTCCGTTTTACGTCTGTGT
TTTCGCACCCTGCGTGTCC -> TTCGCACCCTGCGTGTCCC
TTTCGTGGTCCGGCGAGAG -> TTCGTGGTCCGGCGAGAGA
TTTGAGTGTACGCACAACT -> TTGAGTGTACGCACAACTA
TTTGATCGCTTTGCCCAGG -> TTGATCGCTTTGCCCAGGG
TTTGCATCGGATCGTCCAC -> TTGCATCGGATCGTCCACC
TTTGCCACATCATCGGGCC -> TTGCCACATCATCGGGCCA
TTTGCCCAGGGAGAACTAG -> TTGCCCAGGGAGAACTAGG
TTTGCGTACTACACCGGGT -> TTGCGTACTACACCGGGTG
TTTGGTGGCTATAGATCCT -> TTGGTGGCTATAGATCCTG
TTTGTGAGTGTTCTGTTGT -> TTGTGAGTGTTCTGTTGTA
TTTGTGTGCTATGGACGAA -> TTGTGTGCTATGGACGAAA
TTTTACGTCTGTGTTTTGT -> TTTACGTCTGTGTTTTGTG
TTTTGTGAGTGTTCTGTTG -> TTTGTGAGTGTTCTGTTGT
