AAACGAGGACGAATCCCTCC -> AACGAGGACGAATCCCTCCG
AAACTGAACGGGGGATCGCG -> AACTGAACGGGGGATCGCGC
AAAGAATATTCGTTCCGTCC -> AAGAATATTCGTTCCGTCCC
AAAGCCATTTTACGTACACC -> AAGCCATTTTACGTACACCC
AAAGCGGTGGTGGCGCTGGA -> AAGCGGTGGTGGCGCTGGAT
AAATTGCATCGGTCCTGGAG -> AATTGCATCGGTCCTGGAGG
AACAACTAGGGATATCTGTT -> ACAACTAGGGATATCTGTTC
AACAACTAGTCGTACTTGCG -> ACAACTAGTCGTACTTGCGT
AACCAAACTGAACGGGGGAT -> ACCAAACTGAACGGGGGATC
AACCTTCAGCCTACCATGTG -> ACCTTCAGCCTACCATGTGT
AACCTTCGCCATCAGAACTG -> ACCTTCGCCATCAGAACTGG
AACGAGGACGAATCCCTCCG -> ACGAGGACGAATCCCTCCGT
AACGGGGGATCGCGCGCGTG -> ACGGGGGATCGCGCGCGTGG
AACGTTCGAACAACTAGGGA -> ACGTTCGAACAACTAGGGAT
AACTAGGGATATCTGTTCAG -> ACTAGGGATATCTGTTCAGC
AACTAGTCGTACTTGCGTCG -> ACTAGTCGTACTTGCGTCGG
AACTCAACGTTCGAACAACT -> ACTCAACGTTCGAACAACTA
AACTGAACGGGGGATCGCGC -> ACTGAACGGGGGATCGCGCG
AACTGGATAGCCTCGGGTCC -> ACTGGATAGCCTCGGGTCCC
AACTTGGGAGGTAGCTTAAT -> ACTTGGGAGGTAGCTTAATG
AAGAATATTCGTTCCGTCCC -> AGAATATTCGTTCCGTCCCA
AAGAGGGCGTCAAAGAATAT -> AGAGGGCGTCAAAGAATATT
AAGCAATCTACAACCTTCGC -> AGCAATCTACAACCTTCGCC
AAGCACTCTTGTTACCGCGG -> AGCACTCTTGTTACCGCGGC
AAGCCATTTTACGTACACCC -> AGCCATTTTACGTACACCCA
AAGCCCTAGGAATAGCGCCC -> AGCCCTAGGAATAGCGCCCG
AAGCCTGGCTAGGGTGGGTA -> AGCCTGGCTAGGGTGGGTAG
AAGCGCTGCATACTGTGTTG -> AGCGCTGCATACTGTGTTGT
AAGCGGTGGTGGCGCTGGAT -> AGCGGTGGTGGCGCTGGATT
AAGCTAGTGTAGACAAGCAC -> AGCTAGTGTAGACAAGCACT
AAGCTCATACAGGCCAAGTT -> AGCTCATACAGGCCAAGTTT
AAGCTCTTGGTTCCTACATG -> AGCTCTTGGTTCCTACATGG
AAGTCAGGCTCATGACAAAT -> AGTCAGGCTCATGACAAATT
AAGTCCGGCAGCGGAAGCGC -> AGTCCGGCAGCGGAAGCGCT
AAGTGGTTGTAGGCTGTGGC -> AGTGGTTGTAGGCTGTGGCA
AAGTTTTGATGGCGTGTTTT -> AGTTTTGATGGCGTGTTTTC
AATAGCGCCCGATAGTCAGT -> ATAGCGCCCGATAGTCAGTG
AATATTCGTTCCGTCCCAAG -> ATATTCGTTCCGTCCCAAGC
AATATTGCTCGTAATTTAGT -> ATATTGCTCGTAATTTAGTA
AATCCCTCCGTCTCTATCAC -> ATCCCTCCGTCTCTATCACC
AATCGCGTTATGTAATCGTA -> ATCGCGTTATGTAATCGTAT
AATCGTATATCACCGCTTAT -> ATCGTATATCACCGCTTATA
AATCTACAACCTTCGCCATC -> ATCTACAACCTTCGCCATCA
AATCTTTGGACGTGGTCGAT -> ATCTTTGGACGTGGTCGATC
AATGACTACGTCACACGATC -> ATGACTACGTCACACGATCA
AATTGCATCGGTCCTGGAGG -> ATTGCATCGGTCCTGGAGGT
AATTTACTTGCAACCTTCAG -> ATTTACTTGCAACCTTCAGC
AATTTAGTATGTTGTACACG -> ATTTAGTATGTTGTACACGC
ACAAATTGCATCGGTCCTGG -> CAAATTGCATCGGTCCTGGA
ACAACCTTCGCCATCAGAAC -> CAACCTTCGCCATCAGAACT
ACAACTAGGGATATCTGTTC -> CAACTAGGGATATCTGTTCA
ACAACTAGTCGTACTTGCGT -> CAACTAGTCGTACTTGCGTC
ACAAGCACTCTTGTTACCGC -> CAAGCACTCTTGTTACCGCG
ACACCCATCCACGGCCAGGG -> CACCCATCCACGGCCAGGGA
ACACGACTTTGCATCGAAGC -> CACGACTTTGCATCGAAGCC
ACACGATCATCCGGCCCCCT -> CACGATCATCCGGCCCCCTG
ACACGCTGATGCAACTTGGG -> CACGCTGATGCAACTTGGGA
ACAGGCCAAGTTTTGATGGC -> CAGGCCAAGTTTTGATGGCG
ACATGGGCTTGGGAAGTCCG -> CATGGGCTTGGGAAGTCCGG
ACATGGTTGGAAGTCAGGCT -> CATGGTTGGAAGTCAGGCTC
ACCAAACTGAACGGGGGATC -> CCAAACTGAACGGGGGATCG
ACCACCGCCCAGCTTTCCTG -> CCACCGCCCAGCTTTCCTGG
ACCAGTCCCGGACTGGAGGT -> CCAGTCCCGGACTGGAGGTG
ACCATCTGCAGCTTCTGCTC -> CCATCTGCAGCTTCTGCTCA
ACCATGTGTGTTGGAATCTT -> CCATGTGTGTTGGAATCTTT
ACCCATCCACGGCCAGGGAA -> CCCATCCACGGCCAGGGAAA
ACCCGTCAAGCTCTTGGTTC -> CCCGTCAAGCTCTTGGTTCC
ACCGACACGACTTTGCATCG -> CCGACACGACTTTGCATCGA
ACCGCCCAGCTTTCCTGGCT -> CCGCCCAGCTTTCCTGGCTC
ACCGCGGCTCCATCAGTGTT -> CCGCGGCTCCATCAGTGTTG
ACCGCTTATATCGTAGCCAG -> CCGCTTATATCGTAGCCAGC
ACCTTCAGCCTACCATGTGT -> CCTTCAGCCTACCATGTGTG
ACCTTCGCCATCAGAACTGG -> CCTTCGCCATCAGAACTGGA
ACGAATCCCTCCGTCTCTAT -> CGAATCCCTCCGTCTCTATC
ACGACTTTGCATCGAAGCCC -> CGACTTTGCATCGAAGCCCT
ACGAGGACGAATCCCTCCGT -> CGAGGACGAATCCCTCCGTC
ACGATCATCCGGCCCCCTGT -> CGATCATCCGGCCCCCTGTT
ACGCGGGCAATTTACTTGCA -> CGCGGGCAATTTACTTGCAA
ACGCTGATGCAACTTGGGAG -> CGCTGATGCAACTTGGGAGG
ACGGCCAGGGAAACGAGGAC -> CGGCCAGGGAAACGAGGACG
ACGGGGGATCGCGCGCGTGG -> CGGGGGATCGCGCGCGTGGA
ACGTACACCCATCCACGGCC -> CGTACACCCATCCACGGCCA
ACGTCACACGATCATCCGGC -> CGTCACACGATCATCCGGCC
ACGTGGTCGATCGTCACCAG -> CGTGGTCGATCGTCACCAGT
ACGTTCGAACAACTAGGGAT -> CGTTCGAACAACTAGGGATA
ACTACGTCACACGATCATCC -> CTACGTCACACGATCATCCG
ACTAGGGATATCTGTTCAGC -> CTAGGGATATCTGTTCAGCT
ACTAGGTCGACATGGTTGGA -> CTAGGTCGACATGGTTGGAA
ACTAGTCGTACTTGCGTCGG -> CTAGTCGTACTTGCGTCGGT
ACTATCCCAAGTGGTTGTAG -> CTATCCCAAGTGGTTGTAGG
ACTCAACGTTCGAACAACTA -> CTCAACGTTCGAACAACTAG
ACTCACCGACACGACTTTGC -> CTCACCGACACGACTTTGCA
ACTCTTGTTACCGCGGCTCC -> CTCTTGTTACCGCGGCTCCA
ACTGAACGGGGGATCGCGCG -> CTGAACGGGGGATCGCGCGC
ACTGGAGGTGGAAGCTCATA -> CTGGAGGTGGAAGCTCATAC
ACTGGATAGCCTCGGGTCCC -> CTGGATAGCCTCGGGTCCCT
ACTGTGTTGTGGTTCAGGCT -> CTGTGTTGTGGTTCAGGCTT
ACTTGCAACCTTCAGCCTAC -> CTTGCAACCTTCAGCCTACC
ACTTGCGTCGGTTTTTGTTA -> CTTGCGTCGGTTTTTGTTAA
ACTTGCTTAACCAAACTGAA -> CTTGCTTAACCAAACTGAAC
ACTTGGGAGGTAGCTTAATG -> CTTGGGAGGTAGCTTAATGA
ACTTTGCATCGAAGCCCTAG -> CTTTGCATCGAAGCCCTAGG
AGAACTGGATAGCCTCGGGT -> GAACTGGATAGCCTCGGGTC
AGAAGAGGGCGTCAAAGAAT -> GAAGAGGGCGTCAAAGAATA
AGAATATTCGTTCCGTCCCA -> GAATATTCGTTCCGTCCCAA
AGACAAGCACTCTTGTTACC -> GACAAGCACTCTTGTTACCG
AGACCCGTCAAGCTCTTGGT -> GACCCGTCAAGCTCTTGGTT
AGAGGGCGTCAAAGAATATT -> GAGGGCGTCAAAGAATATTC
AGATGGAGTGTACGCGGGCA -> GATGGAGTGTACGCGGGCAA
AGATTGAGTTGGAGACCCGT -> GATTGAGTTGGAGACCCGTC
AGCAATATTGCTCGTAATTT -> GCAATATTGCTCGTAATTTA
AGCAATCTACAACCTTCGCC -> GCAATCTACAACCTTCGCCA
AGCACTCTTGTTACCGCGGC -> GCACTCTTGTTACCGCGGCT
AGCAGAAGAGGGCGTCAAAG -> GCAGAAGAGGGCGTCAAAGA
AGCCAGCAATATTGCTCGTA -> GCCAGCAATATTGCTCGTAA
AGCCATTTTACGTACACCCA -> GCCATTTTACGTACACCCAT
AGCCCTAGGAATAGCGCCCG -> GCCCTAGGAATAGCGCCCGA
AGCCTACCATGTGTGTTGGA -> GCCTACCATGTGTGTTGGAA
AGCCTCGGGTCCCTATCGCG -> GCCTCGGGTCCCTATCGCGA
AGCCTGGCTAGGGTGGGTAG -> GCCTGGCTAGGGTGGGTAGC
AGCGCAAGCTAGTGTAGACA -> GCGCAAGCTAGTGTAGACAA
AGCGCCCGATAGTCAGTGTT -> GCGCCCGATAGTCAGTGTTT
AGCGCTGCATACTGTGTTGT -> GCGCTGCATACTGTGTTGTG
AGCGGAAGCGCTGCATACTG -> GCGGAAGCGCTGCATACTGT
AGCGGTGGTGGCGCTGGATT -> GCGGTGGTGGCGCTGGATTC
AGCGTGGGAAAGCCATTTTA -> GCGTGGGAAAGCCATTTTAC
AGCTAGTGTAGACAAGCACT -> GCTAGTGTAGACAAGCACTC
AGCTAGTTACCATCTGCAGC -> GCTAGTTACCATCTGCAGCT
AGCTCATACAGGCCAAGTTT -> GCTCATACAGGCCAAGTTTT
AGCTCTTGGTTCCTACATGG -> GCTCTTGGTTCCTACATGGG
AGCTTAATGACTACGTCACA -> GCTTAATGACTACGTCACAC
AGCTTATCTAGCTAGTTACC -> GCTTATCTAGCTAGTTACCA
AGCTTCTGCTCAGATTGAGT -> GCTTCTGCTCAGATTGAGTT
AGCTTGAGCTTATCTAGCTA -> GCTTGAGCTTATCTAGCTAG
AGCTTTCCTGGCTCTGCTCA -> GCTTTCCTGGCTCTGCTCAC
AGGAATAGCGCCCGATAGTC -> GGAATAGCGCCCGATAGTCA
AGGACGAATCCCTCCGTCTC -> GGACGAATCCCTCCGTCTCT
AGGCCAAGTTTTGATGGCGT -> GGCCAAGTTTTGATGGCGTG
AGGCTCATGACAAATTGCAT -> GGCTCATGACAAATTGCATC
AGGCTGTGGCACTTGCTTAA -> GGCTGTGGCACTTGCTTAAC
AGGCTTCGAAAGCGGTGGTG -> GGCTTCGAAAGCGGTGGTGG
AGGGAAACGAGGACGAATCC -> GGGAAACGAGGACGAATCCC
AGGGATATCTGTTCAGCTAC -> GGGATATCTGTTCAGCTACG
AGGGCGTCAAAGAATATTCG -> GGGCGTCAAAGAATATTCGT
AGGGTGGGTAGCGCAAGCTA -> GGGTGGGTAGCGCAAGCTAG
AGGTAGCTTAATGACTACGT -> GGTAGCTTAATGACTACGTC
AGGTCGACATGGTTGGAAGT -> GGTCGACATGGTTGGAAGTC
AGGTGATCGTGTATTGAATC -> GGTGATCGTGTATTGAATCG
AGGTGGAAGCTCATACAGGC -> GGTGGAAGCTCATACAGGCC
AGTATGTTGTACACGCTGAT -> GTATGTTGTACACGCTGATG
AGTCAGGCTCATGACAAATT -> GTCAGGCTCATGACAAATTG
AGTCAGTGTTTATTACTATC -> GTCAGTGTTTATTACTATCC
AGTCCCGGACTGGAGGTGGA -> GTCCCGGACTGGAGGTGGAA
AGTCCGGCAGCGGAAGCGCT -> GTCCGGCAGCGGAAGCGCTG
AGTCGTACTTGCGTCGGTTT -> GTCGTACTTGCGTCGGTTTT
AGTGGTTGTAGGCTGTGGCA -> GTGGTTGTAGGCTGTGGCAC
AGTGTACGCGGGCAATTTAC -> GTGTACGCGGGCAATTTACT
AGTGTAGACAAGCACTCTTG -> GTGTAGACAAGCACTCTTGT
AGTGTTGAGTTCAGATGGAG -> GTGTTGAGTTCAGATGGAGT
AGTGTTTATTACTATCCCAA -> GTGTTTATTACTATCCCAAG
AGTTACCATCTGCAGCTTCT -> GTTACCATCTGCAGCTTCTG
AGTTCAGATGGAGTGTACGC -> GTTCAGATGGAGTGTACGCG
AGTTGGAGACCCGTCAAGCT -> GTTGGAGACCCGTCAAGCTC
AGTTTTGATGGCGTGTTTTC -> GTTTTGATGGCGTGTTTTCT
ATACAGGCCAAGTTTTGATG -> TACAGGCCAAGTTTTGATGG
ATACTGTGTTGTGGTTCAGG -> TACTGTGTTGTGGTTCAGGC
ATAGCCTCGGGTCCCTATCG -> TAGCCTCGGGTCCCTATCGC
ATAGCGCCCGATAGTCAGTG -> TAGCGCCCGATAGTCAGTGT
ATAGTCAGTGTTTATTACTA -> TAGTCAGTGTTTATTACTAT
ATATCACCGCTTATATCGTA -> TATCACCGCTTATATCGTAG
ATATCGTAGCCAGCAATATT -> TATCGTAGCCAGCAATATTG
ATATCTGTTCAGCTACGTCA -> TATCTGTTCAGCTACGTCAC
ATATTCGTTCCGTCCCAAGC -> TATTCGTTCCGTCCCAAGCA
ATATTGCTCGTAATTTAGTA -> TATTGCTCGTAATTTAGTAT
ATCACCACCGCCCAGCTTTC -> TCACCACCGCCCAGCTTTCC
ATCACCGCTTATATCGTAGC -> TCACCGCTTATATCGTAGCC
ATCAGAACTGGATAGCCTCG -> TCAGAACTGGATAGCCTCGG
ATCAGTGTTGAGTTCAGATG -> TCAGTGTTGAGTTCAGATGG
ATCATCCGGCCCCCTGTTAG -> TCATCCGGCCCCCTGTTAGC
ATCCACGGCCAGGGAAACGA -> TCCACGGCCAGGGAAACGAG
ATCCCAAGTGGTTGTAGGCT -> TCCCAAGTGGTTGTAGGCTG
ATCCCTCCGTCTCTATCACC -> TCCCTCCGTCTCTATCACCA
ATCCGGCCCCCTGTTAGCGT -> TCCGGCCCCCTGTTAGCGTG
ATCGAAGCCCTAGGAATAGC -> TCGAAGCCCTAGGAATAGCG
ATCGCGACTAGGTCGACATG -> TCGCGACTAGGTCGACATGG
ATCGCGCGCGTGGAGCTTGA -> TCGCGCGCGTGGAGCTTGAG
ATCGCGTTATGTAATCGTAT -> TCGCGTTATGTAATCGTATA
ATCGGTCCTGGAGGTGATCG -> TCGGTCCTGGAGGTGATCGT
ATCGTAAGCCTGGCTAGGGT -> TCGTAAGCCTGGCTAGGGTG
ATCGTAGCCAGCAATATTGC -> TCGTAGCCAGCAATATTGCT
ATCGTATATCACCGCTTATA -> TCGTATATCACCGCTTATAT
ATCGTCACCAGTCCCGGACT -> TCGTCACCAGTCCCGGACTG
ATCGTGTATTGAATCGCGTT -> TCGTGTATTGAATCGCGTTA
ATCTACAACCTTCGCCATCA -> TCTACAACCTTCGCCATCAG
ATCTAGCTAGTTACCATCTG -> TCTAGCTAGTTACCATCTGC
ATCTGCAGCTTCTGCTCAGA -> TCTGCAGCTTCTGCTCAGAT
ATCTGTTCAGCTACGTCACT -> TCTGTTCAGCTACGTCACTC
ATCTTTGGACGTGGTCGATC -> TCTTTGGACGTGGTCGATCG
ATGACAAATTGCATCGGTCC -> TGACAAATTGCATCGGTCCT
ATGACTACGTCACACGATCA -> TGACTACGTCACACGATCAT
ATGCAACTTGGGAGGTAGCT -> TGCAACTTGGGAGGTAGCTT
ATGGAGTGTACGCGGGCAAT -> TGGAGTGTACGCGGGCAATT
ATGGCGTGTTTTCTAACAAC -> TGGCGTGTTTTCTAACAACT
ATGGGCTTGGGAAGTCCGGC -> TGGGCTTGGGAAGTCCGGCA
ATGGTTGGAAGTCAGGCTCA -> TGGTTGGAAGTCAGGCTCAT
ATGTAATCGTATATCACCGC -> TGTAATCGTATATCACCGCT
ATGTGTGTTGGAATCTTTGG -> TGTGTGTTGGAATCTTTGGA
ATGTTGTACACGCTGATGCA -> TGTTGTACACGCTGATGCAA
ATTACTATCCCAAGTGGTTG -> TTACTATCCCAAGTGGTTGT
ATTCCTGTTGCATCGTAAGC -> TTCCTGTTGCATCGTAAGCC
ATTCGTTCCGTCCCAAGCAA -> TTCGTTCCGTCCCAAGCAAT
ATTGAATCGCGTTATGTAAT -> TTGAATCGCGTTATGTAATC
ATTGAGTTGGAGACCCGTCA -> TTGAGTTGGAGACCCGTCAA
ATTGCATCGGTCCTGGAGGT -> TTGCATCGGTCCTGGAGGTG
ATTGCTCGTAATTTAGTATG -> TTGCTCGTAATTTAGTATGT
ATTTACTTGCAACCTTCAGC -> TTTACTTGCAACCTTCAGCC
ATTTAGTATGTTGTACACGC -> TTTAGTATGTTGTACACGCT
ATTTTACGTACACCCATCCA -> TTTTACGTACACCCATCCAC
CAAACTGAACGGGGGATCGC -> AAACTGAACGGGGGATCGCG
CAAAGAATATTCGTTCCGTC -> AAAGAATATTCGTTCCGTCC
CAAATTGCATCGGTCCTGGA -> AAATTGCATCGGTCCTGGAG
CAACCTTCAGCCTACCATGT -> AACCTTCAGCCTACCATGTG
CAACCTTCGCCATCAGAACT -> AACCTTCGCCATCAGAACTG
CAACGTTCGAACAACTAGGG -> AACGTTCGAACAACTAGGGA
CAACTAGGGATATCTGTTCA -> AACTAGGGATATCTGTTCAG
CAACTAGTCGTACTTGCGTC -> AACTAGTCGTACTTGCGTCG
CAACTTGGGAGGTAGCTTAA -> AACTTGGGAGGTAGCTTAAT
CAAGCAATCTACAACCTTCG -> AAGCAATCTACAACCTTCGC
CAAGCACTCTTGTTACCGCG -> AAGCACTCTTGTTACCGCGG
CAAGCTAGTGTAGACAAGCA -> AAGCTAGTGTAGACAAGCAC
CAAGCTCTTGGTTCCTACAT -> AAGCTCTTGGTTCCTACATG
CAAGTGGTTGTAGGCTGTGG -> AAGTGGTTGTAGGCTGTGGC
CAAGTTTTGATGGCGTGTTT -> AAGTTTTGATGGCGTGTTTT
CAATATTGCTCGTAATTTAG -> AATATTGCTCGTAATTTAGT
CAATCTACAACCTTCGCCAT -> AATCTACAACCTTCGCCATC
CAATTTACTTGCAACCTTCA -> AATTTACTTGCAACCTTCAG
CACACGATCATCCGGCCCCC -> ACACGATCATCCGGCCCCCT
CACCACCGCCCAGCTTTCCT -> ACCACCGCCCAGCTTTCCTG
CACCAGTCCCGGACTGGAGG -> ACCAGTCCCGGACTGGAGGT
CACCCATCCACGGCCAGGGA -> ACCCATCCACGGCCAGGGAA
CACCGACACGACTTTGCATC -> ACCGACACGACTTTGCATCG
CACCGCCCAGCTTTCCTGGC -> ACCGCCCAGCTTTCCTGGCT
CACCGCTTATATCGTAGCCA -> ACCGCTTATATCGTAGCCAG
CACGACTTTGCATCGAAGCC -> ACGACTTTGCATCGAAGCCC
CACGATCATCCGGCCCCCTG -> ACGATCATCCGGCCCCCTGT
CACGCTGATGCAACTTGGGA -> ACGCTGATGCAACTTGGGAG
CACGGCCAGGGAAACGAGGA -> ACGGCCAGGGAAACGAGGAC
CACTCACCGACACGACTTTG -> ACTCACCGACACGACTTTGC
CACTCTTGTTACCGCGGCTC -> ACTCTTGTTACCGCGGCTCC
CACTTGCTTAACCAAACTGA -> ACTTGCTTAACCAAACTGAA
CAGAACTGGATAGCCTCGGG -> AGAACTGGATAGCCTCGGGT
CAGAAGAGGGCGTCAAAGAA -> AGAAGAGGGCGTCAAAGAAT
CAGATGGAGTGTACGCGGGC -> AGATGGAGTGTACGCGGGCA
CAGATTGAGTTGGAGACCCG -> AGATTGAGTTGGAGACCCGT
CAGCAATATTGCTCGTAATT -> AGCAATATTGCTCGTAATTT
CAGCCTACCATGTGTGTTGG -> AGCCTACCATGTGTGTTGGA
CAGCGGAAGCGCTGCATACT -> AGCGGAAGCGCTGCATACTG
CAGCTTCTGCTCAGATTGAG -> AGCTTCTGCTCAGATTGAGT
CAGCTTTCCTGGCTCTGCTC -> AGCTTTCCTGGCTCTGCTCA
CAGGCCAAGTTTTGATGGCG -> AGGCCAAGTTTTGATGGCGT
CAGGCTCATGACAAATTGCA -> AGGCTCATGACAAATTGCAT
CAGGCTTCGAAAGCGGTGGT -> AGGCTTCGAAAGCGGTGGTG
CAGGGAAACGAGGACGAATC -> AGGGAAACGAGGACGAATCC
CAGTCCCGGACTGGAGGTGG -> AGTCCCGGACTGGAGGTGGA
CAGTGTTGAGTTCAGATGGA -> AGTGTTGAGTTCAGATGGAG
CAGTGTTTATTACTATCCCA -> AGTGTTTATTACTATCCCAA
CATACAGGCCAAGTTTTGAT -> ATACAGGCCAAGTTTTGATG
CATACTGTGTTGTGGTTCAG -> ATACTGTGTTGTGGTTCAGG
CATCAGAACTGGATAGCCTC -> ATCAGAACTGGATAGCCTCG
CATCAGTGTTGAGTTCAGAT -> ATCAGTGTTGAGTTCAGATG
CATCCACGGCCAGGGAAACG -> ATCCACGGCCAGGGAAACGA
CATCCGGCCCCCTGTTAGCG -> ATCCGGCCCCCTGTTAGCGT
CATCGAAGCCCTAGGAATAG -> ATCGAAGCCCTAGGAATAGC
CATCGGTCCTGGAGGTGATC -> ATCGGTCCTGGAGGTGATCG
CATCGTAAGCCTGGCTAGGG -> ATCGTAAGCCTGGCTAGGGT
CATCTGCAGCTTCTGCTCAG -> ATCTGCAGCTTCTGCTCAGA
CATGACAAATTGCATCGGTC -> ATGACAAATTGCATCGGTCC
CATGGGCTTGGGAAGTCCGG -> ATGGGCTTGGGAAGTCCGGC
CATGGTTGGAAGTCAGGCTC -> ATGGTTGGAAGTCAGGCTCA
CATGTGTGTTGGAATCTTTG -> ATGTGTGTTGGAATCTTTGG
CATTTTACGTACACCCATCC -> ATTTTACGTACACCCATCCA
CCAAACTGAACGGGGGATCG -> CAAACTGAACGGGGGATCGC
CCAAGCAATCTACAACCTTC -> CAAGCAATCTACAACCTTCG
CCAAGTGGTTGTAGGCTGTG -> CAAGTGGTTGTAGGCTGTGG
CCAAGTTTTGATGGCGTGTT -> CAAGTTTTGATGGCGTGTTT
CCACCGCCCAGCTTTCCTGG -> CACCGCCCAGCTTTCCTGGC
CCACGGCCAGGGAAACGAGG -> CACGGCCAGGGAAACGAGGA
CCAGCAATATTGCTCGTAAT -> CAGCAATATTGCTCGTAATT
CCAGCTTTCCTGGCTCTGCT -> CAGCTTTCCTGGCTCTGCTC
CCAGGGAAACGAGGACGAAT -> CAGGGAAACGAGGACGAATC
CCAGTCCCGGACTGGAGGTG -> CAGTCCCGGACTGGAGGTGG
CCATCAGAACTGGATAGCCT -> CATCAGAACTGGATAGCCTC
CCATCAGTGTTGAGTTCAGA -> CATCAGTGTTGAGTTCAGAT
CCATCCACGGCCAGGGAAAC -> CATCCACGGCCAGGGAAACG
CCATCTGCAGCTTCTGCTCA -> CATCTGCAGCTTCTGCTCAG
CCATGTGTGTTGGAATCTTT -> CATGTGTGTTGGAATCTTTG
CCATTTTACGTACACCCATC -> CATTTTACGTACACCCATCC
CCCAAGCAATCTACAACCTT -> CCAAGCAATCTACAACCTTC
CCCAAGTGGTTGTAGGCTGT -> CCAAGTGGTTGTAGGCTGTG
CCCAGCTTTCCTGGCTCTGC -> CCAGCTTTCCTGGCTCTGCT
CCCATCCACGGCCAGGGAAA -> CCATCCACGGCCAGGGAAAC
CCCCCTGTTAGCGTGGGAAA -> CCCCTGTTAGCGTGGGAAAG
CCCCTGTTAGCGTGGGAAAG -> CCCTGTTAGCGTGGGAAAGC
CCCGATAGTCAGTGTTTATT -> CCGATAGTCAGTGTTTATTA
CCCGGACTGGAGGTGGAAGC -> CCGGACTGGAGGTGGAAGCT
CCCGTCAAGCTCTTGGTTCC -> CCGTCAAGCTCTTGGTTCCT
CCCTAGGAATAGCGCCCGAT -> CCTAGGAATAGCGCCCGATA
CCCTATCGCGACTAGGTCGA -> CCTATCGCGACTAGGTCGAC
CCCTCCGTCTCTATCACCAC -> CCTCCGTCTCTATCACCACC
CCCTGTTAGCGTGGGAAAGC -> CCTGTTAGCGTGGGAAAGCC
CCGACACGACTTTGCATCGA -> CGACACGACTTTGCATCGAA
CCGATAGTCAGTGTTTATTA -> CGATAGTCAGTGTTTATTAC
CCGCCCAGCTTTCCTGGCTC -> CGCCCAGCTTTCCTGGCTCT
CCGCGGCTCCATCAGTGTTG -> CGCGGCTCCATCAGTGTTGA
CCGCTTATATCGTAGCCAGC -> CGCTTATATCGTAGCCAGCA
CCGGACTGGAGGTGGAAGCT -> CGGACTGGAGGTGGAAGCTC
CCGGCAGCGGAAGCGCTGCA -> CGGCAGCGGAAGCGCTGCAT
CCGGCCCCCTGTTAGCGTGG -> CGGCCCCCTGTTAGCGTGGG
CCGTCAAGCTCTTGGTTCCT -> CGTCAAGCTCTTGGTTCCTA
CCGTCCCAAGCAATCTACAA -> CGTCCCAAGCAATCTACAAC
CCGTCTCTATCACCACCGCC -> CGTCTCTATCACCACCGCCC
CCTACATGGGCTTGGGAAGT -> CTACATGGGCTTGGGAAGTC
CCTACCATGTGTGTTGGAAT -> CTACCATGTGTGTTGGAATC
CCTAGGAATAGCGCCCGATA -> CTAGGAATAGCGCCCGATAG
CCTATCGCGACTAGGTCGAC -> CTATCGCGACTAGGTCGACA
CCTCCGTCTCTATCACCACC -> CTCCGTCTCTATCACCACCG
CCTCGGGTCCCTATCGCGAC -> CTCGGGTCCCTATCGCGACT
CCTGGAGGTGATCGTGTATT -> CTGGAGGTGATCGTGTATTG
CCTGGCTAGGGTGGGTAGCG -> CTGGCTAGGGTGGGTAGCGC
CCTGGCTCTGCTCACTCACC -> CTGGCTCTGCTCACTCACCG
CCTGTTAGCGTGGGAAAGCC -> CTGTTAGCGTGGGAAAGCCA
CCTGTTGCATCGTAAGCCTG -> CTGTTGCATCGTAAGCCTGG
CCTTCAGCCTACCATGTGTG -> CTTCAGCCTACCATGTGTGT
CCTTCGCCATCAGAACTGGA -> CTTCGCCATCAGAACTGGAT
CGAAAGCGGTGGTGGCGCTG -> GAAAGCGGTGGTGGCGCTGG
CGAACAACTAGGGATATCTG -> GAACAACTAGGGATATCTGT
CGAAGCCCTAGGAATAGCGC -> GAAGCCCTAGGAATAGCGCC
CGAATCCCTCCGTCTCTATC -> GAATCCCTCCGTCTCTATCA
CGACACGACTTTGCATCGAA -> GACACGACTTTGCATCGAAG
CGACATGGTTGGAAGTCAGG -> GACATGGTTGGAAGTCAGGC
CGACTAGGTCGACATGGTTG -> GACTAGGTCGACATGGTTGG
CGACTTTGCATCGAAGCCCT -> GACTTTGCATCGAAGCCCTA
CGAGGACGAATCCCTCCGTC -> GAGGACGAATCCCTCCGTCT
CGATAGTCAGTGTTTATTAC -> GATAGTCAGTGTTTATTACT
CGATCATCCGGCCCCCTGTT -> GATCATCCGGCCCCCTGTTA
CGATCGTCACCAGTCCCGGA -> GATCGTCACCAGTCCCGGAC
CGCAAGCTAGTGTAGACAAG -> GCAAGCTAGTGTAGACAAGC
CGCCATCAGAACTGGATAGC -> GCCATCAGAACTGGATAGCC
CGCCCAGCTTTCCTGGCTCT -> GCCCAGCTTTCCTGGCTCTG
CGCCCGATAGTCAGTGTTTA -> GCCCGATAGTCAGTGTTTAT
CGCGACTAGGTCGACATGGT -> GCGACTAGGTCGACATGGTT
CGCGCGCGTGGAGCTTGAGC -> GCGCGCGTGGAGCTTGAGCT
CGCGCGTGGAGCTTGAGCTT -> GCGCGTGGAGCTTGAGCTTA
CGCGGCTCCATCAGTGTTGA -> GCGGCTCCATCAGTGTTGAG
CGCGGGCAATTTACTTGCAA -> GCGGGCAATTTACTTGCAAC
CGCGTGGAGCTTGAGCTTAT -> GCGTGGAGCTTGAGCTTATC
CGCGTTATGTAATCGTATAT -> GCGTTATGTAATCGTATATC
CGCTGATGCAACTTGGGAGG -> GCTGATGCAACTTGGGAGGT
CGCTGCATACTGTGTTGTGG -> GCTGCATACTGTGTTGTGGT
CGCTGGATTCCTGTTGCATC -> GCTGGATTCCTGTTGCATCG
CGCTTATATCGTAGCCAGCA -> GCTTATATCGTAGCCAGCAA
CGGAAGCGCTGCATACTGTG -> GGAAGCGCTGCATACTGTGT
CGGACTGGAGGTGGAAGCTC -> GGACTGGAGGTGGAAGCTCA
CGGCAGCGGAAGCGCTGCAT -> GGCAGCGGAAGCGCTGCATA
CGGCCAGGGAAACGAGGACG -> GGCCAGGGAAACGAGGACGA
CGGCCCCCTGTTAGCGTGGG -> GGCCCCCTGTTAGCGTGGGA
CGGCTCCATCAGTGTTGAGT -> GGCTCCATCAGTGTTGAGTT
CGGGCAATTTACTTGCAACC -> GGGCAATTTACTTGCAACCT
CGGGGGATCGCGCGCGTGGA -> GGGGGATCGCGCGCGTGGAG
CGGGTCCCTATCGCGACTAG -> GGGTCCCTATCGCGACTAGG
CGGTCCTGGAGGTGATCGTG -> GGTCCTGGAGGTGATCGTGT
CGGTGGTGGCGCTGGATTCC -> GGTGGTGGCGCTGGATTCCT
CGGTTTTTGTTAACTCAACG -> GGTTTTTGTTAACTCAACGT
CGTAAGCCTGGCTAGGGTGG -> GTAAGCCTGGCTAGGGTGGG
CGTAATTTAGTATGTTGTAC -> GTAATTTAGTATGTTGTACA
CGTACACCCATCCACGGCCA -> GTACACCCATCCACGGCCAG
CGTACTTGCGTCGGTTTTTG -> GTACTTGCGTCGGTTTTTGT
CGTAGCCAGCAATATTGCTC -> GTAGCCAGCAATATTGCTCG
CGTATATCACCGCTTATATC -> GTATATCACCGCTTATATCG
CGTCAAAGAATATTCGTTCC -> GTCAAAGAATATTCGTTCCG
CGTCAAGCTCTTGGTTCCTA -> GTCAAGCTCTTGGTTCCTAC
CGTCACACGATCATCCGGCC -> GTCACACGATCATCCGGCCC
CGTCACCAGTCCCGGACTGG -> GTCACCAGTCCCGGACTGGA
CGTCCCAAGCAATCTACAAC -> GTCCCAAGCAATCTACAACC
CGTCGGTTTTTGTTAACTCA -> GTCGGTTTTTGTTAACTCAA
CGTCTCTATCACCACCGCCC -> GTCTCTATCACCACCGCCCA
CGTGGAGCTTGAGCTTATCT -> GTGGAGCTTGAGCTTATCTA
CGTGGGAAAGCCATTTTACG -> GTGGGAAAGCCATTTTACGT
CGTGGTCGATCGTCACCAGT -> GTGGTCGATCGTCACCAGTC
CGTGTATTGAATCGCGTTAT -> GTGTATTGAATCGCGTTATG
CGTGTTTTCTAACAACTAGT -> GTGTTTTCTAACAACTAGTC
CGTTATGTAATCGTATATCA -> GTTATGTAATCGTATATCAC
CGTTCCGTCCCAAGCAATCT -> GTTCCGTCCCAAGCAATCTA
CGTTCGAACAACTAGGGATA -> GTTCGAACAACTAGGGATAT
CTAACAACTAGTCGTACTTG -> TAACAACTAGTCGTACTTGC
CTACAACCTTCGCCATCAGA -> TACAACCTTCGCCATCAGAA
CTACATGGGCTTGGGAAGTC -> TACATGGGCTTGGGAAGTCC
CTACCATGTGTGTTGGAATC -> TACCATGTGTGTTGGAATCT
CTACGTCACACGATCATCCG -> TACGTCACACGATCATCCGG
CTAGCTAGTTACCATCTGCA -> TAGCTAGTTACCATCTGCAG
CTAGGAATAGCGCCCGATAG -> TAGGAATAGCGCCCGATAGT
CTAGGGATATCTGTTCAGCT -> TAGGGATATCTGTTCAGCTA
CTAGGGTGGGTAGCGCAAGC -> TAGGGTGGGTAGCGCAAGCT
CTAGGTCGACATGGTTGGAA -> TAGGTCGACATGGTTGGAAG
CTAGTCGTACTTGCGTCGGT -> TAGTCGTACTTGCGTCGGTT
CTAGTGTAGACAAGCACTCT -> TAGTGTAGACAAGCACTCTT
CTAGTTACCATCTGCAGCTT -> TAGTTACCATCTGCAGCTTC
CTATCACCACCGCCCAGCTT -> TATCACCACCGCCCAGCTTT
CTATCCCAAGTGGTTGTAGG -> TATCCCAAGTGGTTGTAGGC
CTATCGCGACTAGGTCGACA -> TATCGCGACTAGGTCGACAT
CTCAACGTTCGAACAACTAG -> TCAACGTTCGAACAACTAGG
CTCACCGACACGACTTTGCA -> TCACCGACACGACTTTGCAT
CTCACTCACCGACACGACTT -> TCACTCACCGACACGACTTT
CTCAGATTGAGTTGGAGACC -> TCAGATTGAGTTGGAGACCC
CTCATACAGGCCAAGTTTTG -> TCATACAGGCCAAGTTTTGA
CTCATGACAAATTGCATCGG -> TCATGACAAATTGCATCGGT
CTCCATCAGTGTTGAGTTCA -> TCCATCAGTGTTGAGTTCAG
CTCCGTCTCTATCACCACCG -> TCCGTCTCTATCACCACCGC
CTCGGGTCCCTATCGCGACT -> TCGGGTCCCTATCGCGACTA
CTCGTAATTTAGTATGTTGT -> TCGTAATTTAGTATGTTGTA
CTCTATCACCACCGCCCAGC -> TCTATCACCACCGCCCAGCT
CTCTGCTCACTCACCGACAC -> TCTGCTCACTCACCGACACG
CTCTTGGTTCCTACATGGGC -> TCTTGGTTCCTACATGGGCT
CTCTTGTTACCGCGGCTCCA -> TCTTGTTACCGCGGCTCCAT
CTGAACGGGGGATCGCGCGC -> TGAACGGGGGATCGCGCGCG
CTGATGCAACTTGGGAGGTA -> TGATGCAACTTGGGAGGTAG
CTGCAGCTTCTGCTCAGATT -> TGCAGCTTCTGCTCAGATTG
CTGCATACTGTGTTGTGGTT -> TGCATACTGTGTTGTGGTTC
CTGCTCACTCACCGACACGA -> TGCTCACTCACCGACACGAC
CTGCTCAGATTGAGTTGGAG -> TGCTCAGATTGAGTTGGAGA
CTGGAGGTGATCGTGTATTG -> TGGAGGTGATCGTGTATTGA
CTGGAGGTGGAAGCTCATAC -> TGGAGGTGGAAGCTCATACA
CTGGATAGCCTCGGGTCCCT -> TGGATAGCCTCGGGTCCCTA
CTGGATTCCTGTTGCATCGT -> TGGATTCCTGTTGCATCGTA
CTGGCTAGGGTGGGTAGCGC -> TGGCTAGGGTGGGTAGCGCA
CTGGCTCTGCTCACTCACCG -> TGGCTCTGCTCACTCACCGA
CTGTGGCACTTGCTTAACCA -> TGTGGCACTTGCTTAACCAA
CTGTGTTGTGGTTCAGGCTT -> TGTGTTGTGGTTCAGGCTTC
CTGTTAGCGTGGGAAAGCCA -> TGTTAGCGTGGGAAAGCCAT
CTGTTCAGCTACGTCACTCT -> TGTTCAGCTACGTCACTCTA
CTGTTGCATCGTAAGCCTGG -> TGTTGCATCGTAAGCCTGGC
CTTAACCAAACTGAACGGGG -> TTAACCAAACTGAACGGGGG
CTTAATGACTACGTCACACG -> TTAATGACTACGTCACACGA
CTTATATCGTAGCCAGCAAT -> TTATATCGTAGCCAGCAATA
CTTATCTAGCTAGTTACCAT -> TTATCTAGCTAGTTACCATC
CTTCAGCCTACCATGTGTGT -> TTCAGCCTACCATGTGTGTT
CTTCGAAAGCGGTGGTGGCG -> TTCGAAAGCGGTGGTGGCGC
CTTCGCCATCAGAACTGGAT -> TTCGCCATCAGAACTGGATA
CTTCTGCTCAGATTGAGTTG -> TTCTGCTCAGATTGAGTTGG
CTTGAGCTTATCTAGCTAGT -> TTGAGCTTATCTAGCTAGTT
CTTGCAACCTTCAGCCTACC -> TTGCAACCTTCAGCCTACCA
CTTGCGTCGGTTTTTGTTAA -> TTGCGTCGGTTTTTGTTAAC
CTTGCTTAACCAAACTGAAC -> TTGCTTAACCAAACTGAACG
CTTGGGAAGTCCGGCAGCGG -> TTGGGAAGTCCGGCAGCGGA
CTTGGGAGGTAGCTTAATGA -> TTGGGAGGTAGCTTAATGAC
CTTGGTTCCTACATGGGCTT -> TTGGTTCCTACATGGGCTTG
CTTGTTACCGCGGCTCCATC -> TTGTTACCGCGGCTCCATCA
CTTTCCTGGCTCTGCTCACT -> TTTCCTGGCTCTGCTCACTC
CTTTGCATCGAAGCCCTAGG -> TTTGCATCGAAGCCCTAGGA
CTTTGGACGTGGTCGATCGT -> TTTGGACGTGGTCGATCGTC
GAAACGAGGACGAATCCCTC -> AAACGAGGACGAATCCCTCC
GAAAGCCATTTTACGTACAC -> AAAGCCATTTTACGTACACC
GAAAGCGGTGGTGGCGCTGG -> AAAGCGGTGGTGGCGCTGGA
GAACAACTAGGGATATCTGT -> AACAACTAGGGATATCTGTT
GAACGGGGGATCGCGCGCGT -> AACGGGGGATCGCGCGCGTG
GAACTGGATAGCCTCGGGTC -> AACTGGATAGCCTCGGGTCC
GAAGAGGGCGTCAAAGAATA -> AAGAGGGCGTCAAAGAATAT
GAAGCCCTAGGAATAGCGCC -> AAGCCCTAGGAATAGCGCCC
GAAGCGCTGCATACTGTGTT -> AAGCGCTGCATACTGTGTTG
GAAGCTCATACAGGCCAAGT -> AAGCTCATACAGGCCAAGTT
GAAGTCAGGCTCATGACAAA -> AAGTCAGGCTCATGACAAAT
GAAGTCCGGCAGCGGAAGCG -> AAGTCCGGCAGCGGAAGCGC
GAATAGCGCCCGATAGTCAG -> AATAGCGCCCGATAGTCAGT
GAATATTCGTTCCGTCCCAA -> AATATTCGTTCCGTCCCAAG
GAATCCCTCCGTCTCTATCA -> AATCCCTCCGTCTCTATCAC
GAATCGCGTTATGTAATCGT -> AATCGCGTTATGTAATCGTA
GAATCTTTGGACGTGGTCGA -> AATCTTTGGACGTGGTCGAT
GACAAATTGCATCGGTCCTG -> ACAAATTGCATCGGTCCTGG
GACAAGCACTCTTGTTACCG -> ACAAGCACTCTTGTTACCGC
GACACGACTTTGCATCGAAG -> ACACGACTTTGCATCGAAGC
GACATGGTTGGAAGTCAGGC -> ACATGGTTGGAAGTCAGGCT
GACCCGTCAAGCTCTTGGTT -> ACCCGTCAAGCTCTTGGTTC
GACGAATCCCTCCGTCTCTA -> ACGAATCCCTCCGTCTCTAT
GACGTGGTCGATCGTCACCA -> ACGTGGTCGATCGTCACCAG
GACTACGTCACACGATCATC -> ACTACGTCACACGATCATCC
GACTAGGTCGACATGGTTGG -> ACTAGGTCGACATGGTTGGA
GACTGGAGGTGGAAGCTCAT -> ACTGGAGGTGGAAGCTCATA
GACTTTGCATCGAAGCCCTA -> ACTTTGCATCGAAGCCCTAG
GAGACCCGTCAAGCTCTTGG -> AGACCCGTCAAGCTCTTGGT
GAGCTTATCTAGCTAGTTAC -> AGCTTATCTAGCTAGTTACC
GAGCTTGAGCTTATCTAGCT -> AGCTTGAGCTTATCTAGCTA
GAGGACGAATCCCTCCGTCT -> AGGACGAATCCCTCCGTCTC
GAGGGCGTCAAAGAATATTC -> AGGGCGTCAAAGAATATTCG
GAGGTAGCTTAATGACTACG -> AGGTAGCTTAATGACTACGT
GAGGTGATCGTGTATTGAAT -> AGGTGATCGTGTATTGAATC
GAGGTGGAAGCTCATACAGG -> AGGTGGAAGCTCATACAGGC
GAGTGTACGCGGGCAATTTA -> AGTGTACGCGGGCAATTTAC
GAGTTCAGATGGAGTGTACG -> AGTTCAGATGGAGTGTACGC
GAGTTGGAGACCCGTCAAGC -> AGTTGGAGACCCGTCAAGCT
GATAGCCTCGGGTCCCTATC -> ATAGCCTCGGGTCCCTATCG
GATAGTCAGTGTTTATTACT -> ATAGTCAGTGTTTATTACTA
GATATCTGTTCAGCTACGTC -> ATATCTGTTCAGCTACGTCA
GATCATCCGGCCCCCTGTTA -> ATCATCCGGCCCCCTGTTAG
GATCGCGCGCGTGGAGCTTG -> ATCGCGCGCGTGGAGCTTGA
GATCGTCACCAGTCCCGGAC -> ATCGTCACCAGTCCCGGACT
GATCGTGTATTGAATCGCGT -> ATCGTGTATTGAATCGCGTT
GATGCAACTTGGGAGGTAGC -> ATGCAACTTGGGAGGTAGCT
GATGGAGTGTACGCGGGCAA -> ATGGAGTGTACGCGGGCAAT
GATGGCGTGTTTTCTAACAA -> ATGGCGTGTTTTCTAACAAC
GATTCCTGTTGCATCGTAAG -> ATTCCTGTTGCATCGTAAGC
GATTGAGTTGGAGACCCGTC -> ATTGAGTTGGAGACCCGTCA
GCAACCTTCAGCCTACCATG -> CAACCTTCAGCCTACCATGT
GCAACTTGGGAGGTAGCTTA -> CAACTTGGGAGGTAGCTTAA
GCAAGCTAGTGTAGACAAGC -> CAAGCTAGTGTAGACAAGCA
GCAATATTGCTCGTAATTTA -> CAATATTGCTCGTAATTTAG
GCAATCTACAACCTTCGCCA -> CAATCTACAACCTTCGCCAT
GCAATTTACTTGCAACCTTC -> CAATTTACTTGCAACCTTCA
GCACTCTTGTTACCGCGGCT -> CACTCTTGTTACCGCGGCTC
GCACTTGCTTAACCAAACTG -> CACTTGCTTAACCAAACTGA
GCAGAAGAGGGCGTCAAAGA -> CAGAAGAGGGCGTCAAAGAA
GCAGCGGAAGCGCTGCATAC -> CAGCGGAAGCGCTGCATACT
GCAGCTTCTGCTCAGATTGA -> CAGCTTCTGCTCAGATTGAG
GCATACTGTGTTGTGGTTCA -> CATACTGTGTTGTGGTTCAG
GCATCGAAGCCCTAGGAATA -> CATCGAAGCCCTAGGAATAG
GCATCGGTCCTGGAGGTGAT -> CATCGGTCCTGGAGGTGATC
GCATCGTAAGCCTGGCTAGG -> CATCGTAAGCCTGGCTAGGG
GCCAAGTTTTGATGGCGTGT -> CCAAGTTTTGATGGCGTGTT
GCCAGCAATATTGCTCGTAA -> CCAGCAATATTGCTCGTAAT
GCCAGGGAAACGAGGACGAA -> CCAGGGAAACGAGGACGAAT
GCCATCAGAACTGGATAGCC -> CCATCAGAACTGGATAGCCT
GCCATTTTACGTACACCCAT -> CCATTTTACGTACACCCATC
GCCCAGCTTTCCTGGCTCTG -> CCCAGCTTTCCTGGCTCTGC
GCCCCCTGTTAGCGTGGGAA -> CCCCCTGTTAGCGTGGGAAA
GCCCGATAGTCAGTGTTTAT -> CCCGATAGTCAGTGTTTATT
GCCCTAGGAATAGCGCCCGA -> CCCTAGGAATAGCGCCCGAT
GCCTACCATGTGTGTTGGAA -> CCTACCATGTGTGTTGGAAT
GCCTCGGGTCCCTATCGCGA -> CCTCGGGTCCCTATCGCGAC
GCCTGGCTAGGGTGGGTAGC -> CCTGGCTAGGGTGGGTAGCG
GCGACTAGGTCGACATGGTT -> CGACTAGGTCGACATGGTTG
GCGCAAGCTAGTGTAGACAA -> CGCAAGCTAGTGTAGACAAG
GCGCCCGATAGTCAGTGTTT -> CGCCCGATAGTCAGTGTTTA
GCGCGCGTGGAGCTTGAGCT -> CGCGCGTGGAGCTTGAGCTT
GCGCGTGGAGCTTGAGCTTA -> CGCGTGGAGCTTGAGCTTAT
GCGCTGCATACTGTGTTGTG -> CGCTGCATACTGTGTTGTGG
GCGCTGGATTCCTGTTGCAT -> CGCTGGATTCCTGTTGCATC
GCGGAAGCGCTGCATACTGT -> CGGAAGCGCTGCATACTGTG
GCGGCTCCATCAGTGTTGAG -> CGGCTCCATCAGTGTTGAGT
GCGGGCAATTTACTTGCAAC -> CGGGCAATTTACTTGCAACC
GCGGTGGTGGCGCTGGATTC -> CGGTGGTGGCGCTGGATTCC
GCGTCAAAGAATATTCGTTC -> CGTCAAAGAATATTCGTTCC
GCGTCGGTTTTTGTTAACTC -> CGTCGGTTTTTGTTAACTCA
GCGTGGAGCTTGAGCTTATC -> CGTGGAGCTTGAGCTTATCT
GCGTGGGAAAGCCATTTTAC -> CGTGGGAAAGCCATTTTACG
GCGTGTTTTCTAACAACTAG -> CGTGTTTTCTAACAACTAGT
GCGTTATGTAATCGTATATC -> CGTTATGTAATCGTATATCA
GCTAGGGTGGGTAGCGCAAG -> CTAGGGTGGGTAGCGCAAGC
GCTAGTGTAGACAAGCACTC -> CTAGTGTAGACAAGCACTCT
GCTAGTTACCATCTGCAGCT -> CTAGTTACCATCTGCAGCTT
GCTCACTCACCGACACGACT -> CTCACTCACCGACACGACTT
GCTCAGATTGAGTTGGAGAC -> CTCAGATTGAGTTGGAGACC
GCTCATACAGGCCAAGTTTT -> CTCATACAGGCCAAGTTTTG
GCTCATGACAAATTGCATCG -> CTCATGACAAATTGCATCGG
GCTCCATCAGTGTTGAGTTC -> CTCCATCAGTGTTGAGTTCA
GCTCGTAATTTAGTATGTTG -> CTCGTAATTTAGTATGTTGT
GCTCTGCTCACTCACCGACA -> CTCTGCTCACTCACCGACAC
GCTCTTGGTTCCTACATGGG -> CTCTTGGTTCCTACATGGGC
GCTGATGCAACTTGGGAGGT -> CTGATGCAACTTGGGAGGTA
GCTGCATACTGTGTTGTGGT -> CTGCATACTGTGTTGTGGTT
GCTGGATTCCTGTTGCATCG -> CTGGATTCCTGTTGCATCGT
GCTGTGGCACTTGCTTAACC -> CTGTGGCACTTGCTTAACCA
GCTTAACCAAACTGAACGGG -> CTTAACCAAACTGAACGGGG
GCTTAATGACTACGTCACAC -> CTTAATGACTACGTCACACG
GCTTATATCGTAGCCAGCAA -> CTTATATCGTAGCCAGCAAT
GCTTATCTAGCTAGTTACCA -> CTTATCTAGCTAGTTACCAT
GCTTCGAAAGCGGTGGTGGC -> CTTCGAAAGCGGTGGTGGCG
GCTTCTGCTCAGATTGAGTT -> CTTCTGCTCAGATTGAGTTG
GCTTGAGCTTATCTAGCTAG -> CTTGAGCTTATCTAGCTAGT
GCTTGGGAAGTCCGGCAGCG -> CTTGGGAAGTCCGGCAGCGG
GCTTTCCTGGCTCTGCTCAC -> CTTTCCTGGCTCTGCTCACT
GGAAACGAGGACGAATCCCT -> GAAACGAGGACGAATCCCTC
GGAAAGCCATTTTACGTACA -> GAAAGCCATTTTACGTACAC
GGAAGCGCTGCATACTGTGT -> GAAGCGCTGCATACTGTGTT
GGAAGCTCATACAGGCCAAG -> GAAGCTCATACAGGCCAAGT
GGAAGTCAGGCTCATGACAA -> GAAGTCAGGCTCATGACAAA
GGAAGTCCGGCAGCGGAAGC -> GAAGTCCGGCAGCGGAAGCG
GGAATAGCGCCCGATAGTCA -> GAATAGCGCCCGATAGTCAG
GGAATCTTTGGACGTGGTCG -> GAATCTTTGGACGTGGTCGA
GGACGAATCCCTCCGTCTCT -> GACGAATCCCTCCGTCTCTA
GGACGTGGTCGATCGTCACC -> GACGTGGTCGATCGTCACCA
GGACTGGAGGTGGAAGCTCA -> GACTGGAGGTGGAAGCTCAT
GGAGACCCGTCAAGCTCTTG -> GAGACCCGTCAAGCTCTTGG
GGAGCTTGAGCTTATCTAGC -> GAGCTTGAGCTTATCTAGCT
GGAGGTAGCTTAATGACTAC -> GAGGTAGCTTAATGACTACG
GGAGGTGATCGTGTATTGAA -> GAGGTGATCGTGTATTGAAT
GGAGGTGGAAGCTCATACAG -> GAGGTGGAAGCTCATACAGG
GGAGTGTACGCGGGCAATTT -> GAGTGTACGCGGGCAATTTA
GGATAGCCTCGGGTCCCTAT -> GATAGCCTCGGGTCCCTATC
GGATATCTGTTCAGCTACGT -> GATATCTGTTCAGCTACGTC
GGATCGCGCGCGTGGAGCTT -> GATCGCGCGCGTGGAGCTTG
GGATTCCTGTTGCATCGTAA -> GATTCCTGTTGCATCGTAAG
GGCAATTTACTTGCAACCTT -> GCAATTTACTTGCAACCTTC
GGCACTTGCTTAACCAAACT -> GCACTTGCTTAACCAAACTG
GGCAGCGGAAGCGCTGCATA -> GCAGCGGAAGCGCTGCATAC
GGCCAAGTTTTGATGGCGTG -> GCCAAGTTTTGATGGCGTGT
GGCCAGGGAAACGAGGACGA -> GCCAGGGAAACGAGGACGAA
GGCCCCCTGTTAGCGTGGGA -> GCCCCCTGTTAGCGTGGGAA
GGCGCTGGATTCCTGTTGCA -> GCGCTGGATTCCTGTTGCAT
GGCGTCAAAGAATATTCGTT -> GCGTCAAAGAATATTCGTTC
GGCGTGTTTTCTAACAACTA -> GCGTGTTTTCTAACAACTAG
GGCTAGGGTGGGTAGCGCAA -> GCTAGGGTGGGTAGCGCAAG
GGCTCATGACAAATTGCATC -> GCTCATGACAAATTGCATCG
GGCTCCATCAGTGTTGAGTT -> GCTCCATCAGTGTTGAGTTC
GGCTCTGCTCACTCACCGAC -> GCTCTGCTCACTCACCGACA
GGCTGTGGCACTTGCTTAAC -> GCTGTGGCACTTGCTTAACC
GGCTTCGAAAGCGGTGGTGG -> GCTTCGAAAGCGGTGGTGGC
GGCTTGGGAAGTCCGGCAGC -> GCTTGGGAAGTCCGGCAGCG
GGGAAACGAGGACGAATCCC -> GGAAACGAGGACGAATCCCT
GGGAAAGCCATTTTACGTAC -> GGAAAGCCATTTTACGTACA
GGGAAGTCCGGCAGCGGAAG -> GGAAGTCCGGCAGCGGAAGC
GGGAGGTAGCTTAATGACTA -> GGAGGTAGCTTAATGACTAC
GGGATATCTGTTCAGCTACG -> GGATATCTGTTCAGCTACGT
GGGATCGCGCGCGTGGAGCT -> GGATCGCGCGCGTGGAGCTT
GGGCAATTTACTTGCAACCT -> GGCAATTTACTTGCAACCTT
GGGCGTCAAAGAATATTCGT -> GGCGTCAAAGAATATTCGTT
GGGCTTGGGAAGTCCGGCAG -> GGCTTGGGAAGTCCGGCAGC
GGGGATCGCGCGCGTGGAGC -> GGGATCGCGCGCGTGGAGCT
GGGGGATCGCGCGCGTGGAG -> GGGGATCGCGCGCGTGGAGC
GGGTAGCGCAAGCTAGTGTA -> GGTAGCGCAAGCTAGTGTAG
GGGTCCCTATCGCGACTAGG -> GGTCCCTATCGCGACTAGGT
GGGTGGGTAGCGCAAGCTAG -> GGTGGGTAGCGCAAGCTAGT
GGTAGCGCAAGCTAGTGTAG -> GTAGCGCAAGCTAGTGTAGA
GGTAGCTTAATGACTACGTC -> GTAGCTTAATGACTACGTCA
GGTCCCTATCGCGACTAGGT -> GTCCCTATCGCGACTAGGTC
GGTCCTGGAGGTGATCGTGT -> GTCCTGGAGGTGATCGTGTA
GGTCGACATGGTTGGAAGTC -> GTCGACATGGTTGGAAGTCA
GGTCGATCGTCACCAGTCCC -> GTCGATCGTCACCAGTCCCG
GGTGATCGTGTATTGAATCG -> GTGATCGTGTATTGAATCGC
GGTGGAAGCTCATACAGGCC -> GTGGAAGCTCATACAGGCCA
GGTGGCGCTGGATTCCTGTT -> GTGGCGCTGGATTCCTGTTG
GGTGGGTAGCGCAAGCTAGT -> GTGGGTAGCGCAAGCTAGTG
GGTGGTGGCGCTGGATTCCT -> GTGGTGGCGCTGGATTCCTG
GGTTCAGGCTTCGAAAGCGG -> GTTCAGGCTTCGAAAGCGGT
GGTTCCTACATGGGCTTGGG -> GTTCCTACATGGGCTTGGGA
GGTTGGAAGTCAGGCTCATG -> GTTGGAAGTCAGGCTCATGA
GGTTGTAGGCTGTGGCACTT -> GTTGTAGGCTGTGGCACTTG
GGTTTTTGTTAACTCAACGT -> GTTTTTGTTAACTCAACGTT
GTAAGCCTGGCTAGGGTGGG -> TAAGCCTGGCTAGGGTGGGT
GTAATCGTATATCACCGCTT -> TAATCGTATATCACCGCTTA
GTAATTTAGTATGTTGTACA -> TAATTTAGTATGTTGTACAC
GTACACCCATCCACGGCCAG -> TACACCCATCCACGGCCAGG
GTACACGCTGATGCAACTTG -> TACACGCTGATGCAACTTGG
GTACGCGGGCAATTTACTTG -> TACGCGGGCAATTTACTTGC
GTACTTGCGTCGGTTTTTGT -> TACTTGCGTCGGTTTTTGTT
GTAGACAAGCACTCTTGTTA -> TAGACAAGCACTCTTGTTAC
GTAGCCAGCAATATTGCTCG -> TAGCCAGCAATATTGCTCGT
GTAGCGCAAGCTAGTGTAGA -> TAGCGCAAGCTAGTGTAGAC
GTAGCTTAATGACTACGTCA -> TAGCTTAATGACTACGTCAC
GTAGGCTGTGGCACTTGCTT -> TAGGCTGTGGCACTTGCTTA
GTATATCACCGCTTATATCG -> TATATCACCGCTTATATCGT
GTATGTTGTACACGCTGATG -> TATGTTGTACACGCTGATGC
GTATTGAATCGCGTTATGTA -> TATTGAATCGCGTTATGTAA
GTCAAAGAATATTCGTTCCG -> TCAAAGAATATTCGTTCCGT
GTCAAGCTCTTGGTTCCTAC -> TCAAGCTCTTGGTTCCTACA
GTCACACGATCATCCGGCCC -> TCACACGATCATCCGGCCCC
GTCACCAGTCCCGGACTGGA -> TCACCAGTCCCGGACTGGAG
GTCAGGCTCATGACAAATTG -> TCAGGCTCATGACAAATTGC
GTCAGTGTTTATTACTATCC -> TCAGTGTTTATTACTATCCC
GTCCCAAGCAATCTACAACC -> TCCCAAGCAATCTACAACCT
GTCCCGGACTGGAGGTGGAA -> TCCCGGACTGGAGGTGGAAG
GTCCCTATCGCGACTAGGTC -> TCCCTATCGCGACTAGGTCG
GTCCGGCAGCGGAAGCGCTG -> TCCGGCAGCGGAAGCGCTGC
GTCCTGGAGGTGATCGTGTA -> TCCTGGAGGTGATCGTGTAT
GTCGACATGGTTGGAAGTCA -> TCGACATGGTTGGAAGTCAG
GTCGATCGTCACCAGTCCCG -> TCGATCGTCACCAGTCCCGG
GTCGGTTTTTGTTAACTCAA -> TCGGTTTTTGTTAACTCAAC
GTCGTACTTGCGTCGGTTTT -> TCGTACTTGCGTCGGTTTTT
GTCTCTATCACCACCGCCCA -> TCTCTATCACCACCGCCCAG
GTGATCGTGTATTGAATCGC -> TGATCGTGTATTGAATCGCG
GTGGAAGCTCATACAGGCCA -> TGGAAGCTCATACAGGCCAA
GTGGAGCTTGAGCTTATCTA -> TGGAGCTTGAGCTTATCTAG
GTGGCACTTGCTTAACCAAA -> TGGCACTTGCTTAACCAAAC
GTGGCGCTGGATTCCTGTTG -> TGGCGCTGGATTCCTGTTGC
GTGGGAAAGCCATTTTACGT -> TGGGAAAGCCATTTTACGTA
GTGGGTAGCGCAAGCTAGTG -> TGGGTAGCGCAAGCTAGTGT
GTGGTCGATCGTCACCAGTC -> TGGTCGATCGTCACCAGTCC
GTGGTGGCGCTGGATTCCTG -> TGGTGGCGCTGGATTCCTGT
GTGGTTCAGGCTTCGAAAGC -> TGGTTCAGGCTTCGAAAGCG
GTGGTTGTAGGCTGTGGCAC -> TGGTTGTAGGCTGTGGCACT
GTGTACGCGGGCAATTTACT -> TGTACGCGGGCAATTTACTT
GTGTAGACAAGCACTCTTGT -> TGTAGACAAGCACTCTTGTT
GTGTATTGAATCGCGTTATG -> TGTATTGAATCGCGTTATGT
GTGTGTTGGAATCTTTGGAC -> TGTGTTGGAATCTTTGGACG
GTGTTGAGTTCAGATGGAGT -> TGTTGAGTTCAGATGGAGTG
GTGTTGGAATCTTTGGACGT -> TGTTGGAATCTTTGGACGTG
GTGTTGTGGTTCAGGCTTCG -> TGTTGTGGTTCAGGCTTCGA
GTGTTTATTACTATCCCAAG -> TGTTTATTACTATCCCAAGT
GTGTTTTCTAACAACTAGTC -> TGTTTTCTAACAACTAGTCG
GTTAACTCAACGTTCGAACA -> TTAACTCAACGTTCGAACAA
GTTACCATCTGCAGCTTCTG -> TTACCATCTGCAGCTTCTGC
GTTACCGCGGCTCCATCAGT -> TTACCGCGGCTCCATCAGTG
GTTAGCGTGGGAAAGCCATT -> TTAGCGTGGGAAAGCCATTT
GTTATGTAATCGTATATCAC -> TTATGTAATCGTATATCACC
GTTCAGATGGAGTGTACGCG -> TTCAGATGGAGTGTACGCGG
GTTCAGCTACGTCACTCTAA -> TTCAGCTACGTCACTCTAAA
GTTCAGGCTTCGAAAGCGGT -> TTCAGGCTTCGAAAGCGGTG
GTTCCGTCCCAAGCAATCTA -> TTCCGTCCCAAGCAATCTAC
GTTCCTACATGGGCTTGGGA -> TTCCTACATGGGCTTGGGAA
GTTCGAACAACTAGGGATAT -> TTCGAACAACTAGGGATATC
GTTGAGTTCAGATGGAGTGT -> TTGAGTTCAGATGGAGTGTA
GTTGCATCGTAAGCCTGGCT -> TTGCATCGTAAGCCTGGCTA
GTTGGAAGTCAGGCTCATGA -> TTGGAAGTCAGGCTCATGAC
GTTGGAATCTTTGGACGTGG -> TTGGAATCTTTGGACGTGGT
GTTGGAGACCCGTCAAGCTC -> TTGGAGACCCGTCAAGCTCT
GTTGTACACGCTGATGCAAC -> TTGTACACGCTGATGCAACT
GTTGTAGGCTGTGGCACTTG -> TTGTAGGCTGTGGCACTTGC
GTTGTGGTTCAGGCTTCGAA -> TTGTGGTTCAGGCTTCGAAA
GTTTATTACTATCCCAAGTG -> TTTATTACTATCCCAAGTGG
GTTTTCTAACAACTAGTCGT -> TTTTCTAACAACTAGTCGTA
GTTTTGATGGCGTGTTTTCT -> TTTTGATGGCGTGTTTTCTA
GTTTTTGTTAACTCAACGTT -> TTTTTGTTAACTCAACGTTC
TAACAACTAGTCGTACTTGC -> AACAACTAGTCGTACTTGCG
TAACCAAACTGAACGGGGGA -> AACCAAACTGAACGGGGGAT
TAACTCAACGTTCGAACAAC -> AACTCAACGTTCGAACAACT
TAAGCCTGGCTAGGGTGGGT -> AAGCCTGGCTAGGGTGGGTA
TAATCGTATATCACCGCTTA -> AATCGTATATCACCGCTTAT
TAATGACTACGTCACACGAT -> AATGACTACGTCACACGATC
TAATTTAGTATGTTGTACAC -> AATTTAGTATGTTGTACACG
TACAACCTTCGCCATCAGAA -> ACAACCTTCGCCATCAGAAC
TACACCCATCCACGGCCAGG -> ACACCCATCCACGGCCAGGG
TACACGCTGATGCAACTTGG -> ACACGCTGATGCAACTTGGG
TACAGGCCAAGTTTTGATGG -> ACAGGCCAAGTTTTGATGGC
TACATGGGCTTGGGAAGTCC -> ACATGGGCTTGGGAAGTCCG
TACCATCTGCAGCTTCTGCT -> ACCATCTGCAGCTTCTGCTC
TACCATGTGTGTTGGAATCT -> ACCATGTGTGTTGGAATCTT
TACCGCGGCTCCATCAGTGT -> ACCGCGGCTCCATCAGTGTT
TACGCGGGCAATTTACTTGC -> ACGCGGGCAATTTACTTGCA
TACGTACACCCATCCACGGC -> ACGTACACCCATCCACGGCC
TACGTCACACGATCATCCGG -> ACGTCACACGATCATCCGGC
TACTATCCCAAGTGGTTGTA -> ACTATCCCAAGTGGTTGTAG
TACTGTGTTGTGGTTCAGGC -> ACTGTGTTGTGGTTCAGGCT
TACTTGCAACCTTCAGCCTA -> ACTTGCAACCTTCAGCCTAC
TACTTGCGTCGGTTTTTGTT -> ACTTGCGTCGGTTTTTGTTA
TAGACAAGCACTCTTGTTAC -> AGACAAGCACTCTTGTTACC
TAGCCAGCAATATTGCTCGT -> AGCCAGCAATATTGCTCGTA
TAGCCTCGGGTCCCTATCGC -> AGCCTCGGGTCCCTATCGCG
TAGCGCAAGCTAGTGTAGAC -> AGCGCAAGCTAGTGTAGACA
TAGCGCCCGATAGTCAGTGT -> AGCGCCCGATAGTCAGTGTT
TAGCGTGGGAAAGCCATTTT -> AGCGTGGGAAAGCCATTTTA
TAGCTAGTTACCATCTGCAG -> AGCTAGTTACCATCTGCAGC
TAGCTTAATGACTACGTCAC -> AGCTTAATGACTACGTCACA
TAGGAATAGCGCCCGATAGT -> AGGAATAGCGCCCGATAGTC
TAGGCTGTGGCACTTGCTTA -> AGGCTGTGGCACTTGCTTAA
TAGGGATATCTGTTCAGCTA -> AGGGATATCTGTTCAGCTAC
TAGGGTGGGTAGCGCAAGCT -> AGGGTGGGTAGCGCAAGCTA
TAGGTCGACATGGTTGGAAG -> AGGTCGACATGGTTGGAAGT
TAGTATGTTGTACACGCTGA -> AGTATGTTGTACACGCTGAT
TAGTCAGTGTTTATTACTAT -> AGTCAGTGTTTATTACTATC
TAGTCGTACTTGCGTCGGTT -> AGTCGTACTTGCGTCGGTTT
TAGTGTAGACAAGCACTCTT -> AGTGTAGACAAGCACTCTTG
TAGTTACCATCTGCAGCTTC -> AGTTACCATCTGCAGCTTCT
TATATCACCGCTTATATCGT -> ATATCACCGCTTATATCGTA
TATATCGTAGCCAGCAATAT -> ATATCGTAGCCAGCAATATT
TATCACCACCGCCCAGCTTT -> ATCACCACCGCCCAGCTTTC
TATCACCGCTTATATCGTAG -> ATCACCGCTTATATCGTAGC
TATCCCAAGTGGTTGTAGGC -> ATCCCAAGTGGTTGTAGGCT
TATCGCGACTAGGTCGACAT -> ATCGCGACTAGGTCGACATG
TATCGTAGCCAGCAATATTG -> ATCGTAGCCAGCAATATTGC
TATCTAGCTAGTTACCATCT -> ATCTAGCTAGTTACCATCTG
TATCTGTTCAGCTACGTCAC -> ATCTGTTCAGCTACGTCACT
TATGTAATCGTATATCACCG -> ATGTAATCGTATATCACCGC
TATGTTGTACACGCTGATGC -> ATGTTGTACACGCTGATGCA
TATTACTATCCCAAGTGGTT -> ATTACTATCCCAAGTGGTTG
TATTCGTTCCGTCCCAAGCA -> ATTCGTTCCGTCCCAAGCAA
TATTGAATCGCGTTATGTAA -> ATTGAATCGCGTTATGTAAT
TATTGCTCGTAATTTAGTAT -> ATTGCTCGTAATTTAGTATG
TCAAAGAATATTCGTTCCGT -> CAAAGAATATTCGTTCCGTC
TCAACGTTCGAACAACTAGG -> CAACGTTCGAACAACTAGGG
TCAAGCTCTTGGTTCCTACA -> CAAGCTCTTGGTTCCTACAT
TCACACGATCATCCGGCCCC -> CACACGATCATCCGGCCCCC
TCACCACCGCCCAGCTTTCC -> CACCACCGCCCAGCTTTCCT
TCACCAGTCCCGGACTGGAG -> CACCAGTCCCGGACTGGAGG
TCACCGACACGACTTTGCAT -> CACCGACACGACTTTGCATC
TCACCGCTTATATCGTAGCC -> CACCGCTTATATCGTAGCCA
TCACTCACCGACACGACTTT -> CACTCACCGACACGACTTTG
TCAGAACTGGATAGCCTCGG -> CAGAACTGGATAGCCTCGGG
TCAGATGGAGTGTACGCGGG -> CAGATGGAGTGTACGCGGGC
TCAGATTGAGTTGGAGACCC -> CAGATTGAGTTGGAGACCCG
TCAGCCTACCATGTGTGTTG -> CAGCCTACCATGTGTGTTGG
TCAGGCTCATGACAAATTGC -> CAGGCTCATGACAAATTGCA
TCAGGCTTCGAAAGCGGTGG -> CAGGCTTCGAAAGCGGTGGT
TCAGTGTTGAGTTCAGATGG -> CAGTGTTGAGTTCAGATGGA
TCAGTGTTTATTACTATCCC -> CAGTGTTTATTACTATCCCA
TCATACAGGCCAAGTTTTGA -> CATACAGGCCAAGTTTTGAT
TCATCCGGCCCCCTGTTAGC -> CATCCGGCCCCCTGTTAGCG
TCATGACAAATTGCATCGGT -> CATGACAAATTGCATCGGTC
TCCACGGCCAGGGAAACGAG -> CCACGGCCAGGGAAACGAGG
TCCATCAGTGTTGAGTTCAG -> CCATCAGTGTTGAGTTCAGA
TCCCAAGCAATCTACAACCT -> CCCAAGCAATCTACAACCTT
TCCCAAGTGGTTGTAGGCTG -> CCCAAGTGGTTGTAGGCTGT
TCCCGGACTGGAGGTGGAAG -> CCCGGACTGGAGGTGGAAGC
TCCCTATCGCGACTAGGTCG -> CCCTATCGCGACTAGGTCGA
TCCCTCCGTCTCTATCACCA -> CCCTCCGTCTCTATCACCAC
TCCGGCAGCGGAAGCGCTGC -> CCGGCAGCGGAAGCGCTGCA
TCCGGCCCCCTGTTAGCGTG -> CCGGCCCCCTGTTAGCGTGG
TCCGTCCCAAGCAATCTACA -> CCGTCCCAAGCAATCTACAA
TCCGTCTCTATCACCACCGC -> CCGTCTCTATCACCACCGCC
TCCTACATGGGCTTGGGAAG -> CCTACATGGGCTTGGGAAGT
TCCTGGAGGTGATCGTGTAT -> CCTGGAGGTGATCGTGTATT
TCCTGGCTCTGCTCACTCAC -> CCTGGCTCTGCTCACTCACC
TCCTGTTGCATCGTAAGCCT -> CCTGTTGCATCGTAAGCCTG
TCGAAAGCGGTGGTGGCGCT -> CGAAAGCGGTGGTGGCGCTG
TCGAACAACTAGGGATATCT -> CGAACAACTAGGGATATCTG
TCGAAGCCCTAGGAATAGCG -> CGAAGCCCTAGGAATAGCGC
TCGACATGGTTGGAAGTCAG -> CGACATGGTTGGAAGTCAGG
TCGATCGTCACCAGTCCCGG -> CGATCGTCACCAGTCCCGGA
TCGCCATCAGAACTGGATAG -> CGCCATCAGAACTGGATAGC
TCGCGACTAGGTCGACATGG -> CGCGACTAGGTCGACATGGT
TCGCGCGCGTGGAGCTTGAG -> CGCGCGCGTGGAGCTTGAGC
TCGCGTTATGTAATCGTATA -> CGCGTTATGTAATCGTATAT
TCGGGTCCCTATCGCGACTA -> CGGGTCCCTATCGCGACTAG
TCGGTCCTGGAGGTGATCGT -> CGGTCCTGGAGGTGATCGTG
TCGGTTTTTGTTAACTCAAC -> CGGTTTTTGTTAACTCAACG
TCGTAAGCCTGGCTAGGGTG -> CGTAAGCCTGGCTAGGGTGG
TCGTAATTTAGTATGTTGTA -> CGTAATTTAGTATGTTGTAC
TCGTACTTGCGTCGGTTTTT -> CGTACTTGCGTCGGTTTTTG
TCGTAGCCAGCAATATTGCT -> CGTAGCCAGCAATATTGCTC
TCGTATATCACCGCTTATAT -> CGTATATCACCGCTTATATC
TCGTCACCAGTCCCGGACTG -> CGTCACCAGTCCCGGACTGG
TCGTGTATTGAATCGCGTTA -> CGTGTATTGAATCGCGTTAT
TCGTTCCGTCCCAAGCAATC -> CGTTCCGTCCCAAGCAATCT
TCTAACAACTAGTCGTACTT -> CTAACAACTAGTCGTACTTG
TCTACAACCTTCGCCATCAG -> CTACAACCTTCGCCATCAGA
TCTAGCTAGTTACCATCTGC -> CTAGCTAGTTACCATCTGCA
TCTATCACCACCGCCCAGCT -> CTATCACCACCGCCCAGCTT
TCTCTATCACCACCGCCCAG -> CTCTATCACCACCGCCCAGC
TCTGCAGCTTCTGCTCAGAT -> CTGCAGCTTCTGCTCAGATT
TCTGCTCACTCACCGACACG -> CTGCTCACTCACCGACACGA
TCTGCTCAGATTGAGTTGGA -> CTGCTCAGATTGAGTTGGAG
TCTGTTCAGCTACGTCACTC -> CTGTTCAGCTACGTCACTCT
TCTTGGTTCCTACATGGGCT -> CTTGGTTCCTACATGGGCTT
TCTTGTTACCGCGGCTCCAT -> CTTGTTACCGCGGCTCCATC
TCTTTGGACGTGGTCGATCG -> CTTTGGACGTGGTCGATCGT
TGAACGGGGGATCGCGCGCG -> GAACGGGGGATCGCGCGCGT
TGAATCGCGTTATGTAATCG -> GAATCGCGTTATGTAATCGT
TGACAAATTGCATCGGTCCT -> GACAAATTGCATCGGTCCTG
TGACTACGTCACACGATCAT -> GACTACGTCACACGATCATC
TGAGCTTATCTAGCTAGTTA -> GAGCTTATCTAGCTAGTTAC
TGAGTTCAGATGGAGTGTAC -> GAGTTCAGATGGAGTGTACG
TGAGTTGGAGACCCGTCAAG -> GAGTTGGAGACCCGTCAAGC
TGATCGTGTATTGAATCGCG -> GATCGTGTATTGAATCGCGT
TGATGCAACTTGGGAGGTAG -> GATGCAACTTGGGAGGTAGC
TGATGGCGTGTTTTCTAACA -> GATGGCGTGTTTTCTAACAA
TGCAACCTTCAGCCTACCAT -> GCAACCTTCAGCCTACCATG
TGCAACTTGGGAGGTAGCTT -> GCAACTTGGGAGGTAGCTTA
TGCAGCTTCTGCTCAGATTG -> GCAGCTTCTGCTCAGATTGA
TGCATACTGTGTTGTGGTTC -> GCATACTGTGTTGTGGTTCA
TGCATCGAAGCCCTAGGAAT -> GCATCGAAGCCCTAGGAATA
TGCATCGGTCCTGGAGGTGA -> GCATCGGTCCTGGAGGTGAT
TGCATCGTAAGCCTGGCTAG -> GCATCGTAAGCCTGGCTAGG
TGCGTCGGTTTTTGTTAACT -> GCGTCGGTTTTTGTTAACTC
TGCTCACTCACCGACACGAC -> GCTCACTCACCGACACGACT
TGCTCAGATTGAGTTGGAGA -> GCTCAGATTGAGTTGGAGAC
TGCTCGTAATTTAGTATGTT -> GCTCGTAATTTAGTATGTTG
TGCTTAACCAAACTGAACGG -> GCTTAACCAAACTGAACGGG
TGGAAGCTCATACAGGCCAA -> GGAAGCTCATACAGGCCAAG
TGGAAGTCAGGCTCATGACA -> GGAAGTCAGGCTCATGACAA
TGGAATCTTTGGACGTGGTC -> GGAATCTTTGGACGTGGTCG
TGGACGTGGTCGATCGTCAC -> GGACGTGGTCGATCGTCACC
TGGAGACCCGTCAAGCTCTT -> GGAGACCCGTCAAGCTCTTG
TGGAGCTTGAGCTTATCTAG -> GGAGCTTGAGCTTATCTAGC
TGGAGGTGATCGTGTATTGA -> GGAGGTGATCGTGTATTGAA
TGGAGGTGGAAGCTCATACA -> GGAGGTGGAAGCTCATACAG
TGGAGTGTACGCGGGCAATT -> GGAGTGTACGCGGGCAATTT
TGGATAGCCTCGGGTCCCTA -> GGATAGCCTCGGGTCCCTAT
TGGATTCCTGTTGCATCGTA -> GGATTCCTGTTGCATCGTAA
TGGCACTTGCTTAACCAAAC -> GGCACTTGCTTAACCAAACT
TGGCGCTGGATTCCTGTTGC -> GGCGCTGGATTCCTGTTGCA
TGGCGTGTTTTCTAACAACT -> GGCGTGTTTTCTAACAACTA
TGGCTAGGGTGGGTAGCGCA -> GGCTAGGGTGGGTAGCGCAA
TGGCTCTGCTCACTCACCGA -> GGCTCTGCTCACTCACCGAC
TGGGAAAGCCATTTTACGTA -> GGGAAAGCCATTTTACGTAC
TGGGAAGTCCGGCAGCGGAA -> GGGAAGTCCGGCAGCGGAAG
TGGGAGGTAGCTTAATGACT -> GGGAGGTAGCTTAATGACTA
TGGGCTTGGGAAGTCCGGCA -> GGGCTTGGGAAGTCCGGCAG
TGGGTAGCGCAAGCTAGTGT -> GGGTAGCGCAAGCTAGTGTA
TGGTCGATCGTCACCAGTCC -> GGTCGATCGTCACCAGTCCC
TGGTGGCGCTGGATTCCTGT -> GGTGGCGCTGGATTCCTGTT
TGGTTCAGGCTTCGAAAGCG -> GGTTCAGGCTTCGAAAGCGG
TGGTTCCTACATGGGCTTGG -> GGTTCCTACATGGGCTTGGG
TGGTTGGAAGTCAGGCTCAT -> GGTTGGAAGTCAGGCTCATG
TGGTTGTAGGCTGTGGCACT -> GGTTGTAGGCTGTGGCACTT
TGTAATCGTATATCACCGCT -> GTAATCGTATATCACCGCTT
TGTACACGCTGATGCAACTT -> GTACACGCTGATGCAACTTG
TGTACGCGGGCAATTTACTT -> GTACGCGGGCAATTTACTTG
TGTAGACAAGCACTCTTGTT -> GTAGACAAGCACTCTTGTTA
TGTAGGCTGTGGCACTTGCT -> GTAGGCTGTGGCACTTGCTT
TGTATTGAATCGCGTTATGT -> GTATTGAATCGCGTTATGTA
TGTGGCACTTGCTTAACCAA -> GTGGCACTTGCTTAACCAAA
TGTGGTTCAGGCTTCGAAAG -> GTGGTTCAGGCTTCGAAAGC
TGTGTGTTGGAATCTTTGGA -> GTGTGTTGGAATCTTTGGAC
TGTGTTGGAATCTTTGGACG -> GTGTTGGAATCTTTGGACGT
TGTGTTGTGGTTCAGGCTTC -> GTGTTGTGGTTCAGGCTTCG
TGTTAACTCAACGTTCGAAC -> GTTAACTCAACGTTCGAACA
TGTTACCGCGGCTCCATCAG -> GTTACCGCGGCTCCATCAGT
TGTTAGCGTGGGAAAGCCAT -> GTTAGCGTGGGAAAGCCATT
TGTTCAGCTACGTCACTCTA -> GTTCAGCTACGTCACTCTAA
TGTTGAGTTCAGATGGAGTG -> GTTGAGTTCAGATGGAGTGT
TGTTGCATCGTAAGCCTGGC -> GTTGCATCGTAAGCCTGGCT
TGTTGGAATCTTTGGACGTG -> GTTGGAATCTTTGGACGTGG
TGTTGTACACGCTGATGCAA -> GTTGTACACGCTGATGCAAC
TGTTGTGGTTCAGGCTTCGA -> GTTGTGGTTCAGGCTTCGAA
TGTTTATTACTATCCCAAGT -> GTTTATTACTATCCCAAGTG
TGTTTTCTAACAACTAGTCG -> GTTTTCTAACAACTAGTCGT
TTAACCAAACTGAACGGGGG -> TAACCAAACTGAACGGGGGA
TTAACTCAACGTTCGAACAA -> TAACTCAACGTTCGAACAAC
TTAATGACTACGTCACACGA -> TAATGACTACGTCACACGAT
TTACCATCTGCAGCTTCTGC -> TACCATCTGCAGCTTCTGCT
TTACCGCGGCTCCATCAGTG -> TACCGCGGCTCCATCAGTGT
TTACGTACACCCATCCACGG -> TACGTACACCCATCCACGGC
TTACTATCCCAAGTGGTTGT -> TACTATCCCAAGTGGTTGTA
TTACTTGCAACCTTCAGCCT -> TACTTGCAACCTTCAGCCTA
TTAGCGTGGGAAAGCCATTT -> TAGCGTGGGAAAGCCATTTT
TTAGTATGTTGTACACGCTG -> TAGTATGTTGTACACGCTGA
TTATATCGTAGCCAGCAATA -> TATATCGTAGCCAGCAATAT
TTATCTAGCTAGTTACCATC -> TATCTAGCTAGTTACCATCT
TTATGTAATCGTATATCACC -> TATGTAATCGTATATCACCG
TTATTACTATCCCAAGTGGT -> TATTACTATCCCAAGTGGTT
TTCAGATGGAGTGTACGCGG -> TCAGATGGAGTGTACGCGGG
TTCAGCCTACCATGTGTGTT -> TCAGCCTACCATGTGTGTTG
TTCAGCTACGTCACTCTAAA -> TCAGCTACGTCACTCTAAAT
TTCAGGCTTCGAAAGCGGTG -> TCAGGCTTCGAAAGCGGTGG
TTCCGTCCCAAGCAATCTAC -> TCCGTCCCAAGCAATCTACA
TTCCTACATGGGCTTGGGAA -> TCCTACATGGGCTTGGGAAG
TTCCTGGCTCTGCTCACTCA -> TCCTGGCTCTGCTCACTCAC
TTCCTGTTGCATCGTAAGCC -> TCCTGTTGCATCGTAAGCCT
TTCGAAAGCGGTGGTGGCGC -> TCGAAAGCGGTGGTGGCGCT
TTCGAACAACTAGGGATATC -> TCGAACAACTAGGGATATCT
TTCGCCATCAGAACTGGATA -> TCGCCATCAGAACTGGATAG
TTCGTTCCGTCCCAAGCAAT -> TCGTTCCGTCCCAAGCAATC
TTCTAACAACTAGTCGTACT -> TCTAACAACTAGTCGTACTT
TTCTGCTCAGATTGAGTTGG -> TCTGCTCAGATTGAGTTGGA
TTGAATCGCGTTATGTAATC -> TGAATCGCGTTATGTAATCG
TTGAGCTTATCTAGCTAGTT -> TGAGCTTATCTAGCTAGTTA
TTGAGTTCAGATGGAGTGTA -> TGAGTTCAGATGGAGTGTAC
TTGAGTTGGAGACCCGTCAA -> TGAGTTGGAGACCCGTCAAG
TTGATGGCGTGTTTTCTAAC -> TGATGGCGTGTTTTCTAACA
TTGCAACCTTCAGCCTACCA -> TGCAACCTTCAGCCTACCAT
TTGCATCGAAGCCCTAGGAA -> TGCATCGAAGCCCTAGGAAT
TTGCATCGGTCCTGGAGGTG -> TGCATCGGTCCTGGAGGTGA
TTGCATCGTAAGCCTGGCTA -> TGCATCGTAAGCCTGGCTAG
TTGCGTCGGTTTTTGTTAAC -> TGCGTCGGTTTTTGTTAACT
TTGCTCGTAATTTAGTATGT -> TGCTCGTAATTTAGTATGTT
TTGCTTAACCAAACTGAACG -> TGCTTAACCAAACTGAACGG
TTGGAAGTCAGGCTCATGAC -> TGGAAGTCAGGCTCATGACA
TTGGAATCTTTGGACGTGGT -> TGGAATCTTTGGACGTGGTC
TTGGACGTGGTCGATCGTCA -> TGGACGTGGTCGATCGTCAC
TTGGAGACCCGTCAAGCTCT -> TGGAGACCCGTCAAGCTCTT
TTGGGAAGTCCGGCAGCGGA -> TGGGAAGTCCGGCAGCGGAA
TTGGGAGGTAGCTTAATGAC -> TGGGAGGTAGCTTAATGACT
TTGGTTCCTACATGGGCTTG -> TGGTTCCTACATGGGCTTGG
TTGTACACGCTGATGCAACT -> TGTACACGCTGATGCAACTT
TTGTAGGCTGTGGCACTTGC -> TGTAGGCTGTGGCACTTGCT
TTGTGGTTCAGGCTTCGAAA -> TGTGGTTCAGGCTTCGAAAG
TTGTTAACTCAACGTTCGAA -> TGTTAACTCAACGTTCGAAC
TTGTTACCGCGGCTCCATCA -> TGTTACCGCGGCTCCATCAG
TTTACGTACACCCATCCACG -> TTACGTACACCCATCCACGG
TTTACTTGCAACCTTCAGCC -> TTACTTGCAACCTTCAGCCT
TTTAGTATGTTGTACACGCT -> TTAGTATGTTGTACACGCTG
TTTATTACTATCCCAAGTGG -> TTATTACTATCCCAAGTGGT
TTTCCTGGCTCTGCTCACTC -> TTCCTGGCTCTGCTCACTCA
TTTCTAACAACTAGTCGTAC -> TTCTAACAACTAGTCGTACT
TTTGATGGCGTGTTTTCTAA -> TTGATGGCGTGTTTTCTAAC
TTTGCATCGAAGCCCTAGGA -> TTGCATCGAAGCCCTAGGAA
TTTGGACGTGGTCGATCGTC -> TTGGACGTGGTCGATCGTCA
TTTGTTAACTCAACGTTCGA -> TTGTTAACTCAACGTTCGAA
TTTTACGTACACCCATCCAC -> TTTACGTACACCCATCCACG
TTTTCTAACAACTAGTCGTA -> TTTCTAACAACTAGTCGTAC
TTTTGATGGCGTGTTTTCTA -> TTTGATGGCGTGTTTTCTAA
TTTTGTTAACTCAACGTTCG -> TTTGTTAACTCAACGTTCGA
TTTTTGTTAACTCAACGTTC -> TTTTGTTAACTCAACGTTCG
