AAAACTCGTAG -> AAACTCGTAGC
AAACCCAAGCA -> AACCCAAGCAT
AAACGGGCCAG -> AACGGGCCAGA
AAACTCGTAGC -> AACTCGTAGCA
AAACTTGGGCG -> AACTTGGGCGG
AAAGTCGCGAT -> AAGTCGCGATT
AAATCCCCATG -> AATCCCCATGG
AAATCTAGACC -> AATCTAGACCT
AAATCTCGATG -> AATCTCGATGC
AAATGTATTAC -> AATGTATTACG
AACAAGCACGC -> ACAAGCACGCC
AACAATCCAGA -> ACAATCCAGAT
AACAATGTAGG -> ACAATGTAGGA
AACACCCGAGA -> ACACCCGAGAA
AACAGATGTGC -> ACAGATGTGCC
AACATCTCCTA -> ACATCTCCTAG
AACCCAAGCAT -> ACCCAAGCATC
AACCGGAGCAG -> ACCGGAGCAGT
AACCGGGAAAG -> ACCGGGAAAGT
AACCGTAATGG -> ACCGTAATGGC
AACCGTCAGAA -> ACCGTCAGAAT
AACCGTGTCGA -> ACCGTGTCGAG
AACCTAACGCT -> ACCTAACGCTA
AACGAAGAGGT -> ACGAAGAGGTG
AACGCAAGATG -> ACGCAAGATGA
AACGCAGCACA -> ACGCAGCACAC
AACGCTAAACT -> ACGCTAAACTT
AACGCTCCTCT -> ACGCTCCTCTT
AACGGGCCAGA -> ACGGGCCAGAC
AACGTTATTAG -> ACGTTATTAGG
AACTCGAAGAC -> ACTCGAAGACG
AACTCGACATA -> ACTCGACATAG
AACTCGCGAGG -> ACTCGCGAGGC
AACTCGGAGTA -> ACTCGGAGTAC
AACTCGTAGCA -> ACTCGTAGCAC
AACTGTTAGCT -> ACTGTTAGCTG
AACTTACGCAG -> ACTTACGCAGA
AACTTGCTATA -> ACTTGCTATAC
AACTTGGGCGG -> ACTTGGGCGGT
AACTTTTCTAT -> ACTTTTCTATC
AAGACGCTTTT -> AGACGCTTTTG
AAGAGACCGGA -> AGAGACCGGAG
AAGAGGTGACT -> AGAGGTGACTT
AAGATGACACC -> AGATGACACCA
AAGATTGCCCA -> AGATTGCCCAT
AAGATTTCGTT -> AGATTTCGTTT
AAGCACGCCCC -> AGCACGCCCCA
AAGCACTAAGA -> AGCACTAAGAT
AAGCATCAGCA -> AGCATCAGCAA
AAGCATCCGTA -> AGCATCCGTAA
AAGCGCATCCA -> AGCGCATCCAT
AAGCGCGTGGA -> AGCGCGTGGAG
AAGCGTTTCTG -> AGCGTTTCTGT
AAGCTGATTAG -> AGCTGATTAGA
AAGGCGGCCCC -> AGGCGGCCCCT
AAGGGCGGTGT -> AGGGCGGTGTT
AAGGGGCACTA -> AGGGGCACTAC
AAGGTATCTTG -> AGGTATCTTGC
AAGTCGCGATT -> AGTCGCGATTT
AAGTGGCCGTG -> AGTGGCCGTGT
AAGTGTGCCCA -> AGTGTGCCCAT
AAGTTGTTCCA -> AGTTGTTCCAC
AAGTTTAGTAC -> AGTTTAGTACG
AATACCCGTGT -> ATACCCGTGTG
AATAGAGATAC -> ATAGAGATACG
AATCCAGATTT -> ATCCAGATTTC
AATCCCCATGG -> ATCCCCATGGA
AATCCGGACTA -> ATCCGGACTAA
AATCGTCTCTT -> ATCGTCTCTTA
AATCTAGACCT -> ATCTAGACCTG
AATCTCGATGC -> ATCTCGATGCA
AATGGCGTGCC -> ATGGCGTGCCA
AATGGCTCCGT -> ATGGCTCCGTC
AATGGGCGACC -> ATGGGCGACCC
AATGTAGGAGA -> ATGTAGGAGAT
AATGTATTACG -> ATGTATTACGG
AATTCGATGTG -> ATTCGATGTGA
AATTCGCCTTC -> ATTCGCCTTCG
AATTCTGTCCG -> ATTCTGTCCGA
AATTTGTTGGT -> ATTTGTTGGTT
AATTTTCCGGG -> ATTTTCCGGGG
ACAACGCTCCT -> CAACGCTCCTC
ACAACTCGACA -> CAACTCGACAT
ACAAGATTGCC -> CAAGATTGCCC
ACAAGCACGCC -> CAAGCACGCCC
ACAAGCATCAG -> CAAGCATCAGC
ACAAGGGGCAC -> CAAGGGGCACT
ACAATCCAGAT -> CAATCCAGATT
ACAATCCGGAC -> CAATCCGGACT
ACAATGTAGGA -> CAATGTAGGAG
ACAATTTGTTG -> CAATTTGTTGG
ACACACTCGCT -> CACACTCGCTC
ACACCATAACC -> CACCATAACCG
ACACCCAGCAA -> CACCCAGCAAC
ACACCCGAGAA -> CACCCGAGAAG
ACACCCGTCCT -> CACCCGTCCTC
ACACCGCACAA -> CACCGCACAAT
ACACCTGTAGA -> CACCTGTAGAC
ACACGAAGCGC -> CACGAAGCGCG
ACACGCGAGCA -> CACGCGAGCAC
ACACTAACGAA -> CACTAACGAAG
ACACTCCAGCC -> CACTCCAGCCG
ACACTCGCTCC -> CACTCGCTCCA
ACAGACCCGAT -> CAGACCCGATT
ACAGATGTGCC -> CAGATGTGCCG
ACAGCCGGCGG -> CAGCCGGCGGC
ACAGGCCAGAC -> CAGGCCAGACT
ACAGTACTGCG -> CAGTACTGCGA
ACATAGCGTTA -> CATAGCGTTAG
ACATAGTATAA -> CATAGTATAAC
ACATCTACCTA -> CATCTACCTAC
ACATCTCCTAG -> CATCTCCTAGG
ACATGACCGCT -> CATGACCGCTA
ACATGATTGCA -> CATGATTGCAG
ACATGGGACAC -> CATGGGACACA
ACATGGTTAAC -> CATGGTTAACT
ACATTTTAAGG -> CATTTTAAGGG
ACCACTGAGGG -> CCACTGAGGGG
ACCAGTCCCGA -> CCAGTCCCGAT
ACCATAACCGT -> CCATAACCGTC
ACCCAAGCATC -> CCCAAGCATCC
ACCCAGCAACC -> CCCAGCAACCG
ACCCCCTTCGC -> CCCCCTTCGCA
ACCCGAGAAGT -> CCCGAGAAGTG
ACCCGATTGCA -> CCCGATTGCAA
ACCCGCGGGGG -> CCCGCGGGGGC
ACCCGTCCTCC -> CCCGTCCTCCC
ACCCGTGTGGG -> CCCGTGTGGGA
ACCCTTCAGAT -> CCCTTCAGATC
ACCGACGACTG -> CCGACGACTGT
ACCGATACAAG -> CCGATACAAGG
ACCGATGACAT -> CCGATGACATA
ACCGCACAATT -> CCGCACAATTT
ACCGCGTGTAT -> CCGCGTGTATA
ACCGCTAGGCG -> CCGCTAGGCGC
ACCGGAGCAGT -> CCGGAGCAGTT
ACCGGGAAAGT -> CCGGGAAAGTC
ACCGGGCATAC -> CCGGGCATACA
ACCGTAATGGC -> CCGTAATGGCT
ACCGTAGTCCT -> CCGTAGTCCTT
ACCGTCAGAAT -> CCGTCAGAATT
ACCGTGTCGAG -> CCGTGTCGAGC
ACCTAACGCTA -> CCTAACGCTAA
ACCTACCGCGT -> CCTACCGCGTG
ACCTAGTGAAT -> CCTAGTGAATT
ACCTCACCACT -> CCTCACCACTG
ACCTCATGCGG -> CCTCATGCGGC
ACCTGGGATGG -> CCTGGGATGGA
ACCTGTAGACT -> CCTGTAGACTA
ACCTTAGGGCA -> CCTTAGGGCAG
ACCTTGGTCTA -> CCTTGGTCTAC
ACGAACAATGT -> CGAACAATGTA
ACGAAGAGGTG -> CGAAGAGGTGA
ACGAAGCGCGT -> CGAAGCGCGTG
ACGACTCCCCG -> CGACTCCCCGC
ACGACTGTAGA -> CGACTGTAGAA
ACGAGCTTGAG -> CGAGCTTGAGA
ACGAGCTTTCC -> CGAGCTTTCCT
ACGAGTATTTA -> CGAGTATTTAG
ACGATAAGCAC -> CGATAAGCACT
ACGCAAACGGG -> CGCAAACGGGC
ACGCAAGATGA -> CGCAAGATGAC
ACGCAGAGGAC -> CGCAGAGGACG
ACGCAGCACAC -> CGCAGCACACG
ACGCCCCATCA -> CGCCCCATCAT
ACGCCGGATTT -> CGCCGGATTTA
ACGCGAGCACT -> CGCGAGCACTT
ACGCTAAACTT -> CGCTAAACTTG
ACGCTCCTCTT -> CGCTCCTCTTT
ACGCTTCTTGC -> CGCTTCTTGCC
ACGCTTTTGGC -> CGCTTTTGGCC
ACGGAGCGCTA -> CGGAGCGCTAA
ACGGCCGCCAA -> CGGCCGCCAAA
ACGGGCACCCC -> CGGGCACCCCC
ACGGGCCAGAC -> CGGGCCAGACA
ACGGTAGACCG -> CGGTAGACCGA
ACGGTGCCGGC -> CGGTGCCGGCT
ACGGTTGGACC -> CGGTTGGACCG
ACGTAAATGTA -> CGTAAATGTAT
ACGTACTCTTG -> CGTACTCTTGC
ACGTCTAACTT -> CGTCTAACTTT
ACGTGACTGGC -> CGTGACTGGCA
ACGTTATTAGG -> CGTTATTAGGG
ACTAACAAGCA -> CTAACAAGCAC
ACTAACGAAGA -> CTAACGAAGAG
ACTAAGATTTC -> CTAAGATTTCG
ACTACACTAAC -> CTACACTAACG
ACTACTTCCCT -> CTACTTCCCTT
ACTAGAAGCTG -> CTAGAAGCTGA
ACTAGCACATG -> CTAGCACATGG
ACTAGTTGTAT -> CTAGTTGTATC
ACTATTCTCTC -> CTATTCTCTCC
ACTATTGCGTA -> CTATTGCGTAA
ACTCCAGCCGA -> CTCCAGCCGAC
ACTCCCCGCTG -> CTCCCCGCTGT
ACTCCTGAGTG -> CTCCTGAGTGG
ACTCGAAAACT -> CTCGAAAACTC
ACTCGAAGACG -> CTCGAAGACGC
ACTCGACATAG -> CTCGACATAGC
ACTCGCGAGGC -> CTCGCGAGGCC
ACTCGCTCCAC -> CTCGCTCCACG
ACTCGGAGTAC -> CTCGGAGTACG
ACTCGTAGCAC -> CTCGTAGCACA
ACTCTTGCCGC -> CTCTTGCCGCA
ACTGAGGGGTT -> CTGAGGGGTTA
ACTGCCGGACG -> CTGCCGGACGG
ACTGCGATGGC -> CTGCGATGGCT
ACTGGCAGCCA -> CTGGCAGCCAC
ACTGGCCTGCG -> CTGGCCTGCGC
ACTGTAGAAAT -> CTGTAGAAATC
ACTGTTAGCTG -> CTGTTAGCTGA
ACTTACCGATG -> CTTACCGATGA
ACTTACGCAGA -> CTTACGCAGAG
ACTTAGCCGGT -> CTTAGCCGGTG
ACTTAGCGAAT -> CTTAGCGAATG
ACTTCCCTTGC -> CTTCCCTTGCG
ACTTGAACTCG -> CTTGAACTCGG
ACTTGCTATAC -> CTTGCTATACC
ACTTGGGCGGT -> CTTGGGCGGTT
ACTTTAGGTCG -> CTTTAGGTCGT
ACTTTGGACGA -> CTTTGGACGAC
ACTTTTCTATC -> CTTTTCTATCA
ACTTTTTAACT -> CTTTTTAACTT
AGAAATCTCGA -> GAAATCTCGAT
AGAACCGTAAT -> GAACCGTAATG
AGAACGCAAGA -> GAACGCAAGAT
AGAAGCGTTTC -> GAAGCGTTTCT
AGAAGCTGATT -> GAAGCTGATTA
AGAAGGCGGCC -> GAAGGCGGCCC
AGAAGTGGCCG -> GAAGTGGCCGT
AGAATTCGCCT -> GAATTCGCCTT
AGACACTCCAG -> GACACTCCAGC
AGACCCGATTG -> GACCCGATTGC
AGACCGATACA -> GACCGATACAA
AGACCGGAGAC -> GACCGGAGACA
AGACCGTAGTC -> GACCGTAGTCC
AGACCTGGGAT -> GACCTGGGATG
AGACGAGCTTG -> GACGAGCTTGA
AGACGCTTCTT -> GACGCTTCTTG
AGACGCTTTTG -> GACGCTTTTGG
AGACTACACTA -> GACTACACTAA
AGACTATTGCG -> GACTATTGCGT
AGAGACCGGAG -> GAGACCGGAGA
AGAGATACGAG -> GAGATACGAGC
AGAGCAGATAC -> GAGCAGATACA
AGAGCCGCATA -> GAGCCGCATAT
AGAGCCTATGA -> GAGCCTATGAG
AGAGGACGCCG -> GAGGACGCCGG
AGAGGTGACTT -> GAGGTGACTTT
AGAGTCGACCT -> GAGTCGACCTT
AGATACAAGAT -> GATACAAGATT
AGATACGAGCT -> GATACGAGCTT
AGATCTCTGTT -> GATCTCTGTTT
AGATGACACCA -> GATGACACCAT
AGATGTGCCGG -> GATGTGCCGGA
AGATTAGCCTC -> GATTAGCCTCG
AGATTCAGCAC -> GATTCAGCACA
AGATTGCCCAT -> GATTGCCCATA
AGATTTCGTTT -> GATTTCGTTTT
AGATTTCTGCG -> GATTTCTGCGA
AGCAACCGTGT -> GCAACCGTGTC
AGCAAGGTATC -> GCAAGGTATCT
AGCACAACTCG -> GCACAACTCGA
AGCACAAGCAT -> GCACAAGCATC
AGCACACGCGA -> GCACACGCGAG
AGCACATGGGA -> GCACATGGGAC
AGCACGCCCCA -> GCACGCCCCAT
AGCACTAAGAT -> GCACTAAGATT
AGCACTTGAAC -> GCACTTGAACT
AGCAGATACAA -> GCAGATACAAG
AGCAGTTTCTG -> GCAGTTTCTGT
AGCATCAGCAA -> GCATCAGCAAG
AGCATCCGTAA -> GCATCCGTAAC
AGCATCTACAT -> GCATCTACATC
AGCATTACAAT -> GCATTACAATC
AGCCACCTAGT -> GCCACCTAGTG
AGCCCGCCTGG -> GCCCGCCTGGG
AGCCGACATGG -> GCCGACATGGT
AGCCGCATATA -> GCCGCATATAA
AGCCGGCGGCA -> GCCGGCGGCAT,GCCGGCGGCAT
AGCCGGTGGCC -> GCCGGTGGCCC
AGCCGTCATCT -> GCCGTCATCTG
AGCCTATGAGA -> GCCTATGAGAA
AGCCTCGAACC -> GCCTCGAACCT
AGCGAATGGGC -> GCGAATGGGCG
AGCGACGTACT -> GCGACGTACTC
AGCGCATCCAT -> GCGCATCCATA
AGCGCGTGGAG -> GCGCGTGGAGG
AGCGCTAACCG -> GCGCTAACCGG
AGCGGGAGAAC -> GCGGGAGAACG
AGCGGTTCGGT -> GCGGTTCGGTC
AGCGTTAGAAG -> GCGTTAGAAGG
AGCGTTTCTGT -> GCGTTTCTGTT
AGCTATTCCAC -> GCTATTCCACT
AGCTCTGCTGC -> GCTCTGCTGCG
AGCTGAATGGC -> GCTGAATGGCG
AGCTGAGTGGA -> GCTGAGTGGAG
AGCTGATTAGA -> GCTGATTAGAG
AGCTGCGGAAC -> GCTGCGGAACG
AGCTTACGGCC -> GCTTACGGCCG
AGCTTGAGATT -> GCTTGAGATTC
AGCTTTCCTGG -> GCTTTCCTGGG
AGGACGCCGGA -> GGACGCCGGAT
AGGAGATTAGC -> GGAGATTAGCC
AGGCCAGACTA -> GGCCAGACTAC
AGGCCGTGGGG -> GGCCGTGGGGC
AGGCGCGACAG -> GGCGCGACAGG
AGGCGGCCCCT -> GGCGGCCCCTT
AGGGCAGTTGA -> GGGCAGTTGAT
AGGGCGGTGTT -> GGGCGGTGTTT
AGGGCTACACC -> GGGCTACACCG
AGGGGCACTAC -> GGGGCACTACT
AGGGGTGCACG -> GGGGTGCACGA
AGGGGTTATAC -> GGGGTTATACT
AGGGTAACACC -> GGGTAACACCC
AGGGTGCGGCC -> GGGTGCGGCCT
AGGGTGTCTCA -> GGGTGTCTCAT
AGGTACGAACA -> GGTACGAACAA
AGGTATCTTGC -> GGTATCTTGCC
AGGTCGTGTGA -> GGTCGTGTGAA
AGGTGACTTTG -> GGTGACTTTGG
AGGTTGTAAGT -> GGTTGTAAGTT
AGTAAATCCCC -> GTAAATCCCCA
AGTACGGTGCC -> GTACGGTGCCG
AGTACGTCTAA -> GTACGTCTAAC
AGTACTGCGAT -> GTACTGCGATG
AGTATAACATC -> GTATAACATCT
AGTATCGAGGT -> GTATCGAGGTT
AGTATTTAGCG -> GTATTTAGCGA
AGTCAGCGGTT -> GTCAGCGGTTC
AGTCCCGATAG -> GTCCCGATAGC
AGTCCTTGTAG -> GTCCTTGTAGG
AGTCCTTTCAG -> GTCCTTTCAGA
AGTCGACCTTA -> GTCGACCTTAG
AGTCGCGATTT -> GTCGCGATTTC
AGTGAATTTTC -> GTGAATTTTCC
AGTGATCCATG -> GTGATCCATGT
AGTGCTAGAGC -> GTGCTAGAGCC
AGTGGAGTCAG -> GTGGAGTCAGC
AGTGGAGTGCT -> GTGGAGTGCTA
AGTGGCCGTGT -> GTGGCCGTGTT
AGTGTGCCCAT -> GTGTGCCCATT
AGTTATCGTGG -> GTTATCGTGGT
AGTTGATATCC -> GTTGATATCCT
AGTTGTATCAC -> GTTGTATCACA
AGTTGTTCCAC -> GTTGTTCCACT
AGTTTAGTACG -> GTTTAGTACGT
AGTTTCTGTAT -> GTTTCTGTATA
ATAACATCTCC -> TAACATCTCCT
ATAACCGTCAG -> TAACCGTCAGA
ATAAGAGACCG -> TAAGAGACCGG
ATAAGCACTAA -> TAAGCACTAAG
ATAAGCGCATC -> TAAGCGCATCC
ATAAGTGTGCC -> TAAGTGTGCCC
ATAATACCCGT -> TAATACCCGTG
ATACAAGATTG -> TACAAGATTGC
ATACAAGGGGC -> TACAAGGGGCA
ATACATGACCG -> TACATGACCGC
ATACCAGTCCC -> TACCAGTCCCG
ATACCCGCGGG -> TACCCGCGGGG
ATACCCGTGTG -> TACCCGTGTGG
ATACGAGCTTT -> TACGAGCTTTC
ATACGGTAGAC -> TACGGTAGACC
ATACTATTCTC -> TACTATTCTCT
ATAGAGATACG -> TAGAGATACGA
ATAGCATTACA -> TAGCATTACAA
ATAGCCGGCGG -> TAGCCGGCGGC
ATAGCCGTCAT -> TAGCCGTCATC
ATAGCGTTAGA -> TAGCGTTAGAA
ATAGCTTACGG -> TAGCTTACGGC
ATAGTATAACA -> TAGTATAACAT
ATAGTCCTTTC -> TAGTCCTTTCA
ATATAAGCGCA -> TATAAGCGCAT
ATATACGGTAG -> TATACGGTAGA
ATATCCTCGAC -> TATCCTCGACT
ATATGAATTCG -> TATGAATTCGA
ATATTTCGTTA -> TATTTCGTTAC
ATCACACCCGT -> TCACACCCGTC
ATCACTTAGCC -> TCACTTAGCCG
ATCAGAGCCGC -> TCAGAGCCGCA
ATCAGCAAGGT -> TCAGCAAGGTA
ATCAGCTGAAT -> TCAGCTGAATG
ATCATATTTCG -> TCATATTTCGT
ATCATCACTTA -> TCATCACTTAG
ATCATGATCAT -> TCATGATCATA
ATCCAGATTTC -> TCCAGATTTCT
ATCCATAGCTT -> TCCATAGCTTA
ATCCATGTGGT -> TCCATGTGGTC
ATCCCCATGGA -> TCCCCATGGAC
ATCCCGATGGG -> TCCCGATGGGT
ATCCGGACTAA -> TCCGGACTAAC
ATCCGTAACAA -> TCCGTAACAAT
ATCCTCGACTT -> TCCTCGACTTT
ATCGAGGTTGT -> TCGAGGTTGTA
ATCGTCTCTTA -> TCGTCTCTTAT
ATCGTGGTCGC -> TCGTGGTCGCG
ATCTACATCTA -> TCTACATCTAC
ATCTACCTACC -> TCTACCTACCG
ATCTAGACCTG -> TCTAGACCTGG
ATCTCCTAGGG -> TCTCCTAGGGG
ATCTCGATGCA -> TCTCGATGCAC
ATCTCTGTTTA -> TCTCTGTTTAC
ATCTGTAGCAT -> TCTGTAGCATC
ATCTTGCCAGT -> TCTTGCCAGTG
ATGAATTCGAT -> TGAATTCGATG
ATGACACCATA -> TGACACCATAA
ATGACATAGTA -> TGACATAGTAT
ATGACCGCTAG -> TGACCGCTAGG
ATGACTTTTTA -> TGACTTTTTAA
ATGAGAAGCGT -> TGAGAAGCGTT
ATGATATGAAT -> TGATATGAATT
ATGATCATATT -> TGATCATATTT
ATGATTGCAGC -> TGATTGCAGCT
ATGCACAGCCG -> TGCACAGCCGG
ATGCCCAGTAT -> TGCCCAGTATC
ATGCCTTAGAC -> TGCCTTAGACG
ATGCGATAAGA -> TGCGATAAGAG
ATGCGGCACAG -> TGCGGCACAGA
ATGCGGCCAGC -> TGCGGCCAGCC
ATGGACTTAGC -> TGGACTTAGCG
ATGGATTATGA -> TGGATTATGAT
ATGGCGTGCCA -> TGGCGTGCCAT
ATGGCTCCGTC -> TGGCTCCGTCG
ATGGCTTACGT -> TGGCTTACGTG
ATGGGACACAC -> TGGGACACACT
ATGGGCGACCC -> TGGGCGACCCT
ATGGGTTAGTT -> TGGGTTAGTTA
ATGGTTAACTC -> TGGTTAACTCG
ATGTAGGAGAT -> TGTAGGAGATT
ATGTATTACGG -> TGTATTACGGG
ATGTGATGCCC -> TGTGATGCCCA
ATGTGCCGGAG -> TGTGCCGGAGG
ATGTGGTCGCG -> TGTGGTCGCGA
ATGTTCATAGC -> TGTTCATAGCC
ATTAACTTACG -> TTAACTTACGC
ATTACAATCCG -> TTACAATCCGG
ATTACGGGCAC -> TTACGGGCACC
ATTAGAGCAGA -> TTAGAGCAGAT
ATTAGCCTCGA -> TTAGCCTCGAA
ATTAGGGCTAC -> TTAGGGCTACA
ATTATGATATG -> TTATGATATGA
ATTCAGACGCT -> TTCAGACGCTT
ATTCAGCACAA -> TTCAGCACAAC
ATTCCACTAGA -> TTCCACTAGAA
ATTCGATGTGA -> TTCGATGTGAT
ATTCGCCTTCG -> TTCGCCTTCGC
ATTCTCTCCCG -> TTCTCTCCCGT
ATTCTGTCCGA -> TTCTGTCCGAC
ATTGCAATTCT -> TTGCAATTCTG
ATTGCAGCTGC -> TTGCAGCTGCG
ATTGCCCATAG -> TTGCCCATAGC
ATTGCGTAATC -> TTGCGTAATCG
ATTGTACATGA -> TTGTACATGAT
ATTTAGCGACG -> TTTAGCGACGT
ATTTATGTTCA -> TTTATGTTCAT
ATTTCCGTACT -> TTTCCGTACTC
ATTTCGTTACA -> TTTCGTTACAT
ATTTCGTTTTA -> TTTCGTTTTAA
ATTTCTGCGAC -> TTTCTGCGACC
ATTTGTTGGTT -> TTTGTTGGTTT
ATTTTAAGGGC -> TTTTAAGGGCG
ATTTTCCGGGG -> TTTTCCGGGGC
CAAACCCAAGC -> AAACCCAAGCA
CAAACGGGCCA -> AAACGGGCCAG
CAACCGTGTCG -> AACCGTGTCGA
CAACGCTCCTC -> AACGCTCCTCT
CAACTCGACAT -> AACTCGACATA
CAAGATGACAC -> AAGATGACACC
CAAGATTGCCC -> AAGATTGCCCA
CAAGCACGCCC -> AAGCACGCCCC
CAAGCATCAGC -> AAGCATCAGCA
CAAGCATCCGT -> AAGCATCCGTA
CAAGGGGCACT -> AAGGGGCACTA
CAAGGTATCTT -> AAGGTATCTTG
CAATCCAGATT -> AATCCAGATTT
CAATCCGGACT -> AATCCGGACTA
CAATGTAGGAG -> AATGTAGGAGA
CAATTCTGTCC -> AATTCTGTCCG
CAATTTGTTGG -> AATTTGTTGGT
CACAACTCGAC -> ACAACTCGACA
CACAAGCATCA -> ACAAGCATCAG
CACAATTTGTT -> ACAATTTGTTG
CACACCCAGCA -> ACACCCAGCAA
CACACCCGTCC -> ACACCCGTCCT
CACACGCGAGC -> ACACGCGAGCA
CACACTCGCTC -> ACACTCGCTCC
CACAGACCCGA -> ACAGACCCGAT
CACAGCCGGCG -> ACAGCCGGCGG
CACAGTACTGC -> ACAGTACTGCG
CACATGGGACA -> ACATGGGACAC
CACCACTGAGG -> ACCACTGAGGG
CACCATAACCG -> ACCATAACCGT
CACCCAGCAAC -> ACCCAGCAACC
CACCCCCTTCG -> ACCCCCTTCGC
CACCCGAGAAG -> ACCCGAGAAGT
CACCCGTCCTC -> ACCCGTCCTCC
CACCGCACAAT -> ACCGCACAATT
CACCTAGTGAA -> ACCTAGTGAAT
CACCTGTAGAC -> ACCTGTAGACT
CACCTTGGTCT -> ACCTTGGTCTA
CACGAAGCGCG -> ACGAAGCGCGT
CACGAGTATTT -> ACGAGTATTTA
CACGATAAGCA -> ACGATAAGCAC
CACGCCCCATC -> ACGCCCCATCA
CACGCGAGCAC -> ACGCGAGCACT
CACTAACGAAG -> ACTAACGAAGA
CACTAAGATTT -> ACTAAGATTTC
CACTACTTCCC -> ACTACTTCCCT
CACTAGAAGCT -> ACTAGAAGCTG
CACTAGCACAT -> ACTAGCACATG
CACTAGTTGTA -> ACTAGTTGTAT
CACTCCAGCCG -> ACTCCAGCCGA
CACTCGCTCCA -> ACTCGCTCCAC
CACTGAGGGGT -> ACTGAGGGGTT
CACTTACCGAT -> ACTTACCGATG
CACTTAGCCGG -> ACTTAGCCGGT
CACTTGAACTC -> ACTTGAACTCG
CAGAATTCGCC -> AGAATTCGCCT
CAGACACTCCA -> AGACACTCCAG
CAGACCCGATT -> AGACCCGATTG
CAGACCGTAGT -> AGACCGTAGTC
CAGACGCTTCT -> AGACGCTTCTT
CAGACTACACT -> AGACTACACTA
CAGAGCCGCAT -> AGAGCCGCATA
CAGAGGACGCC -> AGAGGACGCCG
CAGAGTCGACC -> AGAGTCGACCT
CAGATACAAGA -> AGATACAAGAT
CAGATCTCTGT -> AGATCTCTGTT
CAGATGTGCCG -> AGATGTGCCGG
CAGATTTCTGC -> AGATTTCTGCG
CAGCAACCGTG -> AGCAACCGTGT
CAGCAAGGTAT -> AGCAAGGTATC
CAGCACAACTC -> AGCACAACTCG
CAGCACACGCG -> AGCACACGCGA
CAGCCACCTAG -> AGCCACCTAGT
CAGCCCGCCTG -> AGCCCGCCTGG
CAGCCGACATG -> AGCCGACATGG
CAGCCGGCGGC -> AGCCGGCGGCA
CAGCGGTTCGG -> AGCGGTTCGGT
CAGCTCTGCTG -> AGCTCTGCTGC
CAGCTGAATGG -> AGCTGAATGGC
CAGCTGCGGAA -> AGCTGCGGAAC
CAGGCCAGACT -> AGGCCAGACTA
CAGGGTGCGGC -> AGGGTGCGGCC
CAGTACTGCGA -> AGTACTGCGAT
CAGTATCGAGG -> AGTATCGAGGT
CAGTCCCGATA -> AGTCCCGATAG
CAGTGATCCAT -> AGTGATCCATG
CAGTTGATATC -> AGTTGATATCC
CAGTTTCTGTA -> AGTTTCTGTAT
CATAACCGTCA -> ATAACCGTCAG
CATACATGACC -> ATACATGACCG
CATACCCGCGG -> ATACCCGCGGG
CATAGCCGGCG -> ATAGCCGGCGG
CATAGCCGTCA -> ATAGCCGTCAT
CATAGCGTTAG -> ATAGCGTTAGA
CATAGCTTACG -> ATAGCTTACGG
CATAGTATAAC -> ATAGTATAACA
CATATAAGCGC -> ATATAAGCGCA
CATATTTCGTT -> ATATTTCGTTA
CATCACTTAGC -> ATCACTTAGCC
CATCAGAGCCG -> ATCAGAGCCGC
CATCAGCAAGG -> ATCAGCAAGGT
CATCAGCTGAA -> ATCAGCTGAAT
CATCATGATCA -> ATCATGATCAT
CATCCATAGCT -> ATCCATAGCTT
CATCCGTAACA -> ATCCGTAACAA
CATCTACATCT -> ATCTACATCTA
CATCTACCTAC -> ATCTACCTACC
CATCTCCTAGG -> ATCTCCTAGGG
CATCTGTAGCA -> ATCTGTAGCAT
CATGACCGCTA -> ATGACCGCTAG
CATGACTTTTT -> ATGACTTTTTA
CATGATCATAT -> ATGATCATATT
CATGATTGCAG -> ATGATTGCAGC
CATGCCTTAGA -> ATGCCTTAGAC
CATGCGGCACA -> ATGCGGCACAG
CATGGACTTAG -> ATGGACTTAGC
CATGGGACACA -> ATGGGACACAC
CATGGTTAACT -> ATGGTTAACTC
CATGTGGTCGC -> ATGTGGTCGCG
CATTACAATCC -> ATTACAATCCG
CATTCAGACGC -> ATTCAGACGCT
CATTGTACATG -> ATTGTACATGA
CATTTTAAGGG -> ATTTTAAGGGC
CCAAACCCAAG -> CAAACCCAAGC
CCAAGCATCCG -> CAAGCATCCGT
CCACAGTACTG -> CACAGTACTGC
CCACCTAGTGA -> CACCTAGTGAA
CCACGAGTATT -> CACGAGTATTT
CCACTAGAAGC -> CACTAGAAGCT
CCACTAGCACA -> CACTAGCACAT
CCACTGAGGGG -> CACTGAGGGGT
CCAGACACTCC -> CAGACACTCCA
CCAGACTACAC -> CAGACTACACT
CCAGATTTCTG -> CAGATTTCTGC
CCAGCAACCGT -> CAGCAACCGTG
CCAGCCCGCCT -> CAGCCCGCCTG
CCAGCCGACAT -> CAGCCGACATG
CCAGCTCTGCT -> CAGCTCTGCTG
CCAGTATCGAG -> CAGTATCGAGG
CCAGTCCCGAT -> CAGTCCCGATA
CCAGTGATCCA -> CAGTGATCCAT
CCATAACCGTC -> CATAACCGTCA
CCATACCCGCG -> CATACCCGCGG
CCATAGCCGGC -> CATAGCCGGCG
CCATAGCTTAC -> CATAGCTTACG
CCATCATGATC -> CATCATGATCA
CCATGACTTTT -> CATGACTTTTT
CCATGGACTTA -> CATGGACTTAG
CCATGTGGTCG -> CATGTGGTCGC
CCATTCAGACG -> CATTCAGACGC
CCCAAGCATCC -> CCAAGCATCCG
CCCACAGTACT -> CCACAGTACTG
CCCAGCAACCG -> CCAGCAACCGT
CCCAGCTCTGC -> CCAGCTCTGCT
CCCAGTATCGA -> CCAGTATCGAG
CCCATAGCCGG -> CCATAGCCGGC
CCCATCATGAT -> CCATCATGATC
CCCATGACTTT -> CCATGACTTTT
CCCATGGACTT -> CCATGGACTTA
CCCATTCAGAC -> CCATTCAGACG
CCCCATCATGA -> CCCATCATGAT
CCCCATGACTT -> CCCATGACTTT
CCCCATGGACT -> CCCATGGACTT
CCCCCTTCGCA -> CCCCTTCGCAG
CCCCGCTGTAT -> CCCGCTGTATA
CCCCTTCACAC -> CCCTTCACACC
CCCCTTCGCAG -> CCCTTCGCAGG
CCCGAGAAGTG -> CCGAGAAGTGG
CCCGATAGCAT -> CCGATAGCATT
CCCGATGGGTT -> CCGATGGGTTA
CCCGATTGCAA -> CCGATTGCAAT
CCCGCCTGGGA -> CCGCCTGGGAA
CCCGCGGGGGC -> CCGCGGGGGCT
CCCGCTGTATA -> CCGCTGTATAA
CCCGTCCTCCC -> CCGTCCTCCCT
CCCGTGGACGG -> CCGTGGACGGT
CCCGTGTGGGA -> CCGTGTGGGAT
CCCTGACTGGC -> CCTGACTGGCC
CCCTTCACACC -> CCTTCACACCC
CCCTTCAGATC -> CCTTCAGATCT
CCCTTCGCAGG -> CCTTCGCAGGG
CCCTTGCGTAC -> CCTTGCGTACA
CCGACATGGTT -> CGACATGGTTA
CCGACGACTGT -> CGACGACTGTA
CCGACGTAAAT -> CGACGTAAATG
CCGAGAAGTGG -> CGAGAAGTGGC
CCGATACAAGG -> CGATACAAGGG
CCGATAGCATT -> CGATAGCATTA
CCGATGACATA -> CGATGACATAG
CCGATGGGTTA -> CGATGGGTTAG
CCGATTGCAAT -> CGATTGCAATT
CCGCACAATTT -> CGCACAATTTG
CCGCACTTACC -> CGCACTTACCG
CCGCATATAAG -> CGCATATAAGC
CCGCCAAACCC -> CGCCAAACCCA
CCGCCTGGGAA -> CGCCTGGGAAC
CCGCCTTTGAA -> CGCCTTTGAAT
CCGCGGGGGCT -> CGCGGGGGCTT
CCGCGTGTATA -> CGCGTGTATAT
CCGCTAGGCGC -> CGCTAGGCGCG
CCGCTGTATAA -> CGCTGTATAAG
CCGGACGGAGC -> CGGACGGAGCG
CCGGACTAACA -> CGGACTAACAA
CCGGAGCAGTT -> CGGAGCAGTTT
CCGGAGGGTAA -> CGGAGGGTAAC
CCGGATTTATG -> CGGATTTATGT
CCGGCGGCATC -> CGGCGGCATCA
CCGGCGGCATT -> CGGCGGCATTG
CCGGCTACTGC -> CGGCTACTGCC
CCGGGAAAGTC -> CGGGAAAGTCG
CCGGGCATACA -> CGGGCATACAT
CCGGGGCGGTT -> CGGGGCGGTTT
CCGGTGGCCCA -> CGGTGGCCCAG
CCGTAACAATC -> CGTAACAATCC
CCGTAATGGCT -> CGTAATGGCTC
CCGTACTCGAA -> CGTACTCGAAA
CCGTAGTCCTT -> CGTAGTCCTTG
CCGTCAGAATT -> CGTCAGAATTC
CCGTCATCTGT -> CGTCATCTGTA
CCGTCCTCCCT -> CGTCCTCCCTG
CCGTCGCTAAC -> CGTCGCTAACT
CCGTGGACGGT -> CGTGGACGGTT
CCGTGGGGCTG -> CGTGGGGCTGA
CCGTGTCGAGC -> CGTGTCGAGCT
CCGTGTGGGAT -> CGTGTGGGATG
CCGTGTTGACG -> CGTGTTGACGC
CCTAAATCTAG -> CTAAATCTAGA
CCTAACGCTAA -> CTAACGCTAAA
CCTACCGCGTG -> CTACCGCGTGT
CCTAGGGGTGC -> CTAGGGGTGCA
CCTAGTGAATT -> CTAGTGAATTT
CCTATGAGAAG -> CTATGAGAAGC
CCTCACCACTG -> CTCACCACTGA
CCTCATGCGGC -> CTCATGCGGCA
CCTCCCTGACT -> CTCCCTGACTG
CCTCCGCCTTT -> CTCCGCCTTTG
CCTCGAACCTA -> CTCGAACCTAA
CCTCGACTTTA -> CTCGACTTTAG
CCTCTTTCAGA -> CTCTTTCAGAC
CCTGACTGGCC -> CTGACTGGCCT
CCTGAGTGGAG -> CTGAGTGGAGT
CCTGCCTCCGC -> CTGCCTCCGCC
CCTGCGCCTGC -> CTGCGCCTGCC
CCTGGGAACTC -> CTGGGAACTCG
CCTGGGATGGA -> CTGGGATGGAT
CCTGGGGCACC -> CTGGGGCACCT
CCTGTAGACTA -> CTGTAGACTAT
CCTTAGAACCG -> CTTAGAACCGT
CCTTAGACGAG -> CTTAGACGAGC
CCTTAGGGCAG -> CTTAGGGCAGT
CCTTCACACCC -> CTTCACACCCA
CCTTCAGATCT -> CTTCAGATCTC
CCTTCGCAGGG -> CTTCGCAGGGT
CCTTCGCCTTC -> CTTCGCCTTCG
CCTTCGTTTGG -> CTTCGTTTGGG
CCTTGCGTACA -> CTTGCGTACAC
CCTTGGTCTAC -> CTTGGTCTACC
CCTTGTAGGTA -> CTTGTAGGTAC
CCTTTCAGAGT -> CTTTCAGAGTC
CCTTTGAATAG -> CTTTGAATAGA
CGAAAACTCGT -> GAAAACTCGTA
CGAACAATGTA -> GAACAATGTAG
CGAACCTAACG -> GAACCTAACGC
CGAAGACGCTT -> GAAGACGCTTT
CGAAGAGGTGA -> GAAGAGGTGAC
CGAAGCGCGTG -> GAAGCGCGTGG
CGAATGGGCGA -> GAATGGGCGAC
CGACAACGCTC -> GACAACGCTCC
CGACAGGCCAG -> GACAGGCCAGA
CGACATAGCGT -> GACATAGCGTT
CGACATGGTTA -> GACATGGTTAA
CGACCCTTCAG -> GACCCTTCAGA
CGACCTCATGC -> GACCTCATGCG
CGACCTTAGGG -> GACCTTAGGGC
CGACGACTGTA -> GACGACTGTAG
CGACGTAAATG -> GACGTAAATGT
CGACGTACTCT -> GACGTACTCTT
CGACTCCCCGC -> GACTCCCCGCT
CGACTGTAGAA -> GACTGTAGAAA
CGACTTTAGGT -> GACTTTAGGTC
CGAGAAGTGGC -> GAGAAGTGGCC
CGAGCACTTGA -> GAGCACTTGAA
CGAGCTATTCC -> GAGCTATTCCA
CGAGCTTGAGA -> GAGCTTGAGAT
CGAGCTTTCCT -> GAGCTTTCCTG
CGAGGCCGTGG -> GAGGCCGTGGG
CGAGGTTGTAA -> GAGGTTGTAAG
CGAGTATTTAG -> GAGTATTTAGC
CGATAAGAGAC -> GATAAGAGACC
CGATAAGCACT -> GATAAGCACTA
CGATACAAGGG -> GATACAAGGGG
CGATAGCATTA -> GATAGCATTAC
CGATGACATAG -> GATGACATAGT
CGATGCACAGC -> GATGCACAGCC
CGATGGCTTAC -> GATGGCTTACG
CGATGGGTTAG -> GATGGGTTAGT
CGATGTGATGC -> GATGTGATGCC
CGATTGCAATT -> GATTGCAATTC
CGATTTCCGTA -> GATTTCCGTAC
CGCAAACGGGC -> GCAAACGGGCC
CGCAAGATGAC -> GCAAGATGACA
CGCACAATTTG -> GCACAATTTGT
CGCACTTACCG -> GCACTTACCGA
CGCAGAGGACG -> GCAGAGGACGC
CGCAGCACACG -> GCAGCACACGC
CGCAGGGTGCG -> GCAGGGTGCGG
CGCATATAAGC -> GCATATAAGCG
CGCATCAGAGC -> GCATCAGAGCC
CGCATCCATAG -> GCATCCATAGC
CGCCAAACCCA -> GCCAAACCCAA
CGCCCCATCAT -> GCCCCATCATG
CGCCGGATTTA -> GCCGGATTTAT
CGCCTGCCTCC -> GCCTGCCTCCG
CGCCTGGGAAC -> GCCTGGGAACT
CGCCTTCGCCT -> GCCTTCGCCTT
CGCCTTCGTTT -> GCCTTCGTTTG
CGCCTTTGAAT -> GCCTTTGAATA
CGCGACAACGC -> GCGACAACGCT
CGCGACAGGCC -> GCGACAGGCCA
CGCGAGCACTT -> GCGAGCACTTG
CGCGAGGCCGT -> GCGAGGCCGTG
CGCGATTTCCG -> GCGATTTCCGT
CGCGCATCAGA -> GCGCATCAGAG
CGCGGGGGCTT -> GCGGGGGCTTC
CGCGTGGAGGG -> GCGTGGAGGGT
CGCGTGTATAT -> GCGTGTATATA
CGCTAAACTTG -> GCTAAACTTGG
CGCTAACCGGA -> GCTAACCGGAG
CGCTAACTGTT -> GCTAACTGTTA
CGCTAGGCGCG -> GCTAGGCGCGA
CGCTCCACGAG -> GCTCCACGAGT
CGCTCCTCTTT -> GCTCCTCTTTC
CGCTGTATAAG -> GCTGTATAAGT
CGCTTCTTGCC -> GCTTCTTGCCC
CGCTTTTGGCC -> GCTTTTGGCCT
CGGAACGCAGC -> GGAACGCAGCA
CGGACGGAGCG -> GGACGGAGCGC
CGGACTAACAA -> GGACTAACAAG
CGGAGCAGTTT -> GGAGCAGTTTC
CGGAGCGCTAA -> GGAGCGCTAAC
CGGAGGGTAAC -> GGAGGGTAACA
CGGAGTACGGT -> GGAGTACGGTG
CGGATGCGGCC -> GGATGCGGCCA
CGGATTTATGT -> GGATTTATGTT
CGGCACAGACC -> GGCACAGACCC
CGGCATCAGCT -> GGCATCAGCTG
CGGCATTGTAC -> GGCATTGTACA
CGGCCAGCCCG -> GGCCAGCCCGC
CGGCCCCTTCA -> GGCCCCTTCAC
CGGCCGCCAAA -> GGCCGCCAAAC
CGGCCTTAGAA -> GGCCTTAGAAC
CGGCGGCATCA -> GGCGGCATCAG
CGGCGGCATTG -> GGCGGCATTGT
CGGCTACTGCC -> GGCTACTGCCG
CGGGAAAGTCG -> GGGAAAGTCGC
CGGGAGAACGC -> GGGAGAACGCA
CGGGCACCCCC -> GGGCACCCCCT
CGGGCATACAT -> GGGCATACATG
CGGGCCAGACA -> GGGCCAGACAC
CGGGGCGGTTT -> GGGGCGGTTTA
CGGGGGCTTCT -> GGGGGCTTCTA
CGGTAGACCGA -> GGTAGACCGAT
CGGTCTCCCCA -> GGTCTCCCCAT
CGGTGCCGGCT -> GGTGCCGGCTA
CGGTGGCCCAG -> GGTGGCCCAGC
CGGTGTTTCTA -> GGTGTTTCTAC
CGGTTATCCCG -> GGTTATCCCGA
CGGTTCGGTCT -> GGTTCGGTCTC
CGGTTGGACCG -> GGTTGGACCGG
CGGTTTAACAG -> GGTTTAACAGA
CGTAAATGTAT -> GTAAATGTATT
CGTAACAATCC -> GTAACAATCCA
CGTAATCGTCT -> GTAATCGTCTC
CGTAATGGCTC -> GTAATGGCTCC
CGTACACCTGT -> GTACACCTGTA
CGTACTCGAAA -> GTACTCGAAAA
CGTACTCTTGC -> GTACTCTTGCC
CGTAGCACAAG -> GTAGCACAAGC
CGTAGTCCTTG -> GTAGTCCTTGT
CGTCAGAATTC -> GTCAGAATTCG
CGTCATCTGTA -> GTCATCTGTAG
CGTCCTCCCTG -> GTCCTCCCTGA
CGTCGCTAACT -> GTCGCTAACTG
CGTCTAACTTT -> GTCTAACTTTT
CGTCTCTTATA -> GTCTCTTATAA
CGTGACTGGCA -> GTGACTGGCAG
CGTGCCATACC -> GTGCCATACCC
CGTGGACGGTT -> GTGGACGGTTG
CGTGGAGGGTG -> GTGGAGGGTGT
CGTGGGGCTGA -> GTGGGGCTGAA
CGTGGTCGCGC -> GTGGTCGCGCA
CGTGTATATAC -> GTGTATATACG
CGTGTCGAGCT -> GTGTCGAGCTA
CGTGTGAACGT -> GTGTGAACGTT
CGTGTGGGATG -> GTGTGGGATGC
CGTGTTGACGC -> GTGTTGACGCA
CGTTACATTTT -> GTTACATTTTA
CGTTAGAAGGC -> GTTAGAAGGCG
CGTTATTAGGG -> GTTATTAGGGC
CGTTTCTGTTG -> GTTTCTGTTGA
CGTTTGGGGTG -> GTTTGGGGTGG
CGTTTTAAGTT -> GTTTTAAGTTT
CTAAACTTGGG -> TAAACTTGGGC
CTAAATCTAGA -> TAAATCTAGAC
CTAACAAGCAC -> TAACAAGCACG
CTAACCGGAGC -> TAACCGGAGCA
CTAACGAAGAG -> TAACGAAGAGG
CTAACGCTAAA -> TAACGCTAAAC
CTAACTGTTAG -> TAACTGTTAGC
CTAACTTTTCT -> TAACTTTTCTA
CTAAGATTTCG -> TAAGATTTCGT
CTACACCGCAC -> TACACCGCACA
CTACACGAAGC -> TACACGAAGCG
CTACACTAACG -> TACACTAACGA
CTACATCTACC -> TACATCTACCT
CTACCGACGAC -> TACCGACGACT
CTACCGCGTGT -> TACCGCGTGTA
CTACCTACCGC -> TACCTACCGCG
CTACCTCACCA -> TACCTCACCAC
CTACTGCCGGA -> TACTGCCGGAC
CTACTTCCCTT -> TACTTCCCTTG
CTAGAAGCTGA -> TAGAAGCTGAT
CTAGACCTGGG -> TAGACCTGGGA
CTAGAGCCTAT -> TAGAGCCTATG
CTAGCACATGG -> TAGCACATGGG
CTAGCGGGAGA -> TAGCGGGAGAA
CTAGGCGCGAC -> TAGGCGCGACA
CTAGGGGTGCA -> TAGGGGTGCAC
CTAGTGAATTT -> TAGTGAATTTT
CTAGTTGTATC -> TAGTTGTATCA
CTATACCAGTC -> TATACCAGTCC
CTATCATCACT -> TATCATCACTT
CTATGAGAAGC -> TATGAGAAGCG
CTATTCCACTA -> TATTCCACTAG
CTATTCTCTCC -> TATTCTCTCCC
CTATTGCGTAA -> TATTGCGTAAT
CTCACCACTGA -> TCACCACTGAG
CTCATGCCTTA -> TCATGCCTTAG
CTCATGCGGCA -> TCATGCGGCAC
CTCCACGAGTA -> TCCACGAGTAT
CTCCAGCCGAC -> TCCAGCCGACA
CTCCCCATGAC -> TCCCCATGACT
CTCCCCGCTGT -> TCCCCGCTGTA
CTCCCGTGGAC -> TCCCGTGGACG
CTCCCTGACTG -> TCCCTGACTGG
CTCCGCCTTTG -> TCCGCCTTTGA
CTCCGTCGCTA -> TCCGTCGCTAA
CTCCTAGGGGT -> TCCTAGGGGTG
CTCCTCTTTCA -> TCCTCTTTCAG
CTCCTGAGTGG -> TCCTGAGTGGA
CTCGAAAACTC -> TCGAAAACTCG
CTCGAACCTAA -> TCGAACCTAAC
CTCGAAGACGC -> TCGAAGACGCT
CTCGACATAGC -> TCGACATAGCG
CTCGACTTTAG -> TCGACTTTAGG
CTCGATGCACA -> TCGATGCACAG
CTCGCGAGGCC -> TCGCGAGGCCG
CTCGCTCCACG -> TCGCTCCACGA
CTCGGAGTACG -> TCGGAGTACGG
CTCGTAGCACA -> TCGTAGCACAA
CTCTCCCGTGG -> TCTCCCGTGGA
CTCTGCTGCGG -> TCTGCTGCGGA
CTCTGTTTACT -> TCTGTTTACTC
CTCTTATAATA -> TCTTATAATAC
CTCTTGCCGCA -> TCTTGCCGCAC
CTCTTTCAGAC -> TCTTTCAGACC
CTGAACCGGGA -> TGAACCGGGAA
CTGAATGGCGT -> TGAATGGCGTG
CTGACTGGCCT -> TGACTGGCCTG
CTGAGGGGTTA -> TGAGGGGTTAT
CTGAGTGGAGT -> TGAGTGGAGTC,TGAGTGGAGTG
CTGATTAGAGC -> TGATTAGAGCA
CTGCCGGACGG -> TGCCGGACGGA
CTGCCTCCGCC -> TGCCTCCGCCT
CTGCGACCTCA -> TGCGACCTCAT
CTGCGATGGCT -> TGCGATGGCTT
CTGCGCCTGCC -> TGCGCCTGCCT
CTGCGGAACGC -> TGCGGAACGCA
CTGCGGATGCG -> TGCGGATGCGG
CTGCTGCGGAT -> TGCTGCGGATG
CTGGCAGCCAC -> TGGCAGCCACC
CTGGCCTGCGC -> TGGCCTGCGCC
CTGGGAACTCG -> TGGGAACTCGC
CTGGGATGGAT -> TGGGATGGATT
CTGGGGCACCT -> TGGGGCACCTT
CTGTAGAAATC -> TGTAGAAATCT
CTGTAGACTAT -> TGTAGACTATT
CTGTAGCATCT -> TGTAGCATCTA
CTGTATAAGTG -> TGTATAAGTGT
CTGTATAGTCC -> TGTATAGTCCT
CTGTCCGACGT -> TGTCCGACGTA
CTGTTAGCTGA -> TGTTAGCTGAG
CTGTTGATTAA -> TGTTGATTAAC
CTGTTTACTCC -> TGTTTACTCCT
CTTACCGATGA -> TTACCGATGAC
CTTACGCAGAG -> TTACGCAGAGG
CTTACGGCCGC -> TTACGGCCGCC
CTTACGTGACT -> TTACGTGACTG
CTTAGAACCGT -> TTAGAACCGTA
CTTAGACGAGC -> TTAGACGAGCT
CTTAGCCGGTG -> TTAGCCGGTGG
CTTAGCGAATG -> TTAGCGAATGG
CTTAGGGCAGT -> TTAGGGCAGTT
CTTATAATACC -> TTATAATACCC
CTTCACACCCA -> TTCACACCCAG
CTTCAGATCTC -> TTCAGATCTCT
CTTCCCTTGCG -> TTCCCTTGCGT
CTTCGCAGGGT -> TTCGCAGGGTG
CTTCGCCTTCG -> TTCGCCTTCGT
CTTCGTTTGGG -> TTCGTTTGGGG
CTTCTACCTCA -> TTCTACCTCAC
CTTCTTGCCCA -> TTCTTGCCCAC
CTTGAACTCGG -> TTGAACTCGGA
CTTGAGATTCA -> TTGAGATTCAG
CTTGCCAGTGA -> TTGCCAGTGAT
CTTGCCCACAG -> TTGCCCACAGT
CTTGCCGCACT -> TTGCCGCACTT
CTTGCGTACAC -> TTGCGTACACC
CTTGCTATACC -> TTGCTATACCA
CTTGGGCGGTT -> TTGGGCGGTTA
CTTGGTCTACC -> TTGGTCTACCG
CTTGTAGGTAC -> TTGTAGGTACG
CTTTAGGTCGT -> TTTAGGTCGTG
CTTTCAGACCG -> TTTCAGACCGT
CTTTCAGAGTC -> TTTCAGAGTCG
CTTTCCTGGGG -> TTTCCTGGGGC
CTTTGAATAGA -> TTTGAATAGAG
CTTTGGACGAC -> TTTGGACGACT
CTTTTCTATCA -> TTTTCTATCAT
CTTTTGGCCTA -> TTTTGGCCTAA
CTTTTTAACTT -> TTTTTAACTTG
GAAAACTCGTA -> AAAACTCGTAG
GAAAGTCGCGA -> AAAGTCGCGAT
GAAATCTCGAT -> AAATCTCGATG
GAACAATGTAG -> AACAATGTAGG
GAACCGGGAAA -> AACCGGGAAAG
GAACCGTAATG -> AACCGTAATGG
GAACCTAACGC -> AACCTAACGCT
GAACGCAAGAT -> AACGCAAGATG
GAACGCAGCAC -> AACGCAGCACA
GAACGTTATTA -> AACGTTATTAG
GAACTCGCGAG -> AACTCGCGAGG
GAACTCGGAGT -> AACTCGGAGTA
GAAGACGCTTT -> AAGACGCTTTT
GAAGAGGTGAC -> AAGAGGTGACT
GAAGCGCGTGG -> AAGCGCGTGGA
GAAGCGTTTCT -> AAGCGTTTCTG
GAAGCTGATTA -> AAGCTGATTAG
GAAGGCGGCCC -> AAGGCGGCCCC
GAAGTGGCCGT -> AAGTGGCCGTG
GAATAGAGATA -> AATAGAGATAC
GAATGGCGTGC -> AATGGCGTGCC
GAATGGGCGAC -> AATGGGCGACC
GAATTCGATGT -> AATTCGATGTG
GAATTCGCCTT -> AATTCGCCTTC
GAATTTTCCGG -> AATTTTCCGGG
GACAACGCTCC -> ACAACGCTCCT
GACACACTCGC -> ACACACTCGCT
GACACCATAAC -> ACACCATAACC
GACACTCCAGC -> ACACTCCAGCC
GACAGGCCAGA -> ACAGGCCAGAC
GACATAGCGTT -> ACATAGCGTTA
GACATAGTATA -> ACATAGTATAA
GACATGGTTAA -> ACATGGTTAAC
GACCCGATTGC -> ACCCGATTGCA
GACCCTTCAGA -> ACCCTTCAGAT
GACCGATACAA -> ACCGATACAAG
GACCGCTAGGC -> ACCGCTAGGCG
GACCGGAGACA -> ACCGGAGACAA
GACCGGGCATA -> ACCGGGCATAC
GACCGTAGTCC -> ACCGTAGTCCT
GACCTCATGCG -> ACCTCATGCGG
GACCTGGGATG -> ACCTGGGATGG
GACCTTAGGGC -> ACCTTAGGGCA
GACGACTCCCC -> ACGACTCCCCG
GACGACTGTAG -> ACGACTGTAGA
GACGAGCTTGA -> ACGAGCTTGAG
GACGCAAACGG -> ACGCAAACGGG
GACGCCGGATT -> ACGCCGGATTT
GACGCTTCTTG -> ACGCTTCTTGC
GACGCTTTTGG -> ACGCTTTTGGC
GACGGAGCGCT -> ACGGAGCGCTA
GACGGTTGGAC -> ACGGTTGGACC
GACGTAAATGT -> ACGTAAATGTA
GACGTACTCTT -> ACGTACTCTTG
GACTAACAAGC -> ACTAACAAGCA
GACTACACTAA -> ACTACACTAAC
GACTATTGCGT -> ACTATTGCGTA
GACTCCCCGCT -> ACTCCCCGCTG
GACTGGCAGCC -> ACTGGCAGCCA
GACTGGCCTGC -> ACTGGCCTGCG
GACTGTAGAAA -> ACTGTAGAAAT
GACTTAGCGAA -> ACTTAGCGAAT
GACTTTAGGTC -> ACTTTAGGTCG
GACTTTGGACG -> ACTTTGGACGA
GACTTTTTAAC -> ACTTTTTAACT
GAGAACGCAAG -> AGAACGCAAGA
GAGAAGCGTTT -> AGAAGCGTTTC
GAGAAGTGGCC -> AGAAGTGGCCG
GAGACCGGAGA -> AGACCGGAGAC
GAGATACGAGC -> AGATACGAGCT
GAGATTAGCCT -> AGATTAGCCTC
GAGATTCAGCA -> AGATTCAGCAC
GAGCACTTGAA -> AGCACTTGAAC
GAGCAGATACA -> AGCAGATACAA
GAGCAGTTTCT -> AGCAGTTTCTG
GAGCCGCATAT -> AGCCGCATATA
GAGCCTATGAG -> AGCCTATGAGA
GAGCGCTAACC -> AGCGCTAACCG
GAGCTATTCCA -> AGCTATTCCAC
GAGCTTGAGAT -> AGCTTGAGATT
GAGCTTTCCTG -> AGCTTTCCTGG
GAGGACGCCGG -> AGGACGCCGGA
GAGGCCGTGGG -> AGGCCGTGGGG
GAGGGGTTATA -> AGGGGTTATAC
GAGGGTAACAC -> AGGGTAACACC
GAGGGTGTCTC -> AGGGTGTCTCA
GAGGTGACTTT -> AGGTGACTTTG
GAGGTTGTAAG -> AGGTTGTAAGT
GAGTAAATCCC -> AGTAAATCCCC
GAGTACGGTGC -> AGTACGGTGCC
GAGTATTTAGC -> AGTATTTAGCG
GAGTCAGCGGT -> AGTCAGCGGTT
GAGTCGACCTT -> AGTCGACCTTA
GAGTGCTAGAG -> AGTGCTAGAGC
GAGTGGAGTCA -> AGTGGAGTCAG
GAGTGGAGTGC -> AGTGGAGTGCT
GATAAGAGACC -> ATAAGAGACCG
GATAAGCACTA -> ATAAGCACTAA
GATACAAGATT -> ATACAAGATTG
GATACAAGGGG -> ATACAAGGGGC
GATACGAGCTT -> ATACGAGCTTT
GATAGCATTAC -> ATAGCATTACA
GATATCCTCGA -> ATATCCTCGAC
GATATGAATTC -> ATATGAATTCG
GATCATATTTC -> ATCATATTTCG
GATCCATGTGG -> ATCCATGTGGT
GATCTCTGTTT -> ATCTCTGTTTA
GATGACACCAT -> ATGACACCATA
GATGACATAGT -> ATGACATAGTA
GATGCACAGCC -> ATGCACAGCCG
GATGCCCAGTA -> ATGCCCAGTAT
GATGCGATAAG -> ATGCGATAAGA
GATGCGGCCAG -> ATGCGGCCAGC
GATGGATTATG -> ATGGATTATGA
GATGGCTTACG -> ATGGCTTACGT
GATGGGTTAGT -> ATGGGTTAGTT
GATGTGATGCC -> ATGTGATGCCC
GATGTGCCGGA -> ATGTGCCGGAG
GATTAACTTAC -> ATTAACTTACG
GATTAGAGCAG -> ATTAGAGCAGA
GATTAGCCTCG -> ATTAGCCTCGA
GATTATGATAT -> ATTATGATATG
GATTCAGCACA -> ATTCAGCACAA
GATTGCAATTC -> ATTGCAATTCT
GATTGCAGCTG -> ATTGCAGCTGC
GATTGCCCATA -> ATTGCCCATAG
GATTTATGTTC -> ATTTATGTTCA
GATTTCCGTAC -> ATTTCCGTACT
GATTTCGTTTT -> ATTTCGTTTTA
GATTTCTGCGA -> ATTTCTGCGAC
GCAAACGGGCC -> CAAACGGGCCA
GCAACCGTGTC -> CAACCGTGTCG
GCAAGATGACA -> CAAGATGACAC
GCAAGGTATCT -> CAAGGTATCTT
GCAATTCTGTC -> CAATTCTGTCC
GCACAACTCGA -> CACAACTCGAC
GCACAAGCATC -> CACAAGCATCA
GCACAATTTGT -> CACAATTTGTT
GCACACGCGAG -> CACACGCGAGC
GCACAGACCCG -> CACAGACCCGA
GCACAGCCGGC -> CACAGCCGGCG
GCACATGGGAC -> CACATGGGACA
GCACCCCCTTC -> CACCCCCTTCG
GCACCTTGGTC -> CACCTTGGTCT
GCACGATAAGC -> CACGATAAGCA
GCACGCCCCAT -> CACGCCCCATC
GCACTAAGATT -> CACTAAGATTT
GCACTACTTCC -> CACTACTTCCC
GCACTTACCGA -> CACTTACCGAT
GCACTTGAACT -> CACTTGAACTC
GCAGAGGACGC -> CAGAGGACGCC
GCAGATACAAG -> CAGATACAAGA
GCAGCACACGC -> CAGCACACGCG
GCAGCCACCTA -> CAGCCACCTAG
GCAGCTGCGGA -> CAGCTGCGGAA
GCAGGGTGCGG -> CAGGGTGCGGC
GCAGTTGATAT -> CAGTTGATATC
GCAGTTTCTGT -> CAGTTTCTGTA
GCATACATGAC -> CATACATGACC
GCATATAAGCG -> CATATAAGCGC
GCATCAGAGCC -> CATCAGAGCCG
GCATCAGCAAG -> CATCAGCAAGG
GCATCAGCTGA -> CATCAGCTGAA
GCATCCATAGC -> CATCCATAGCT
GCATCCGTAAC -> CATCCGTAACA
GCATCTACATC -> CATCTACATCT
GCATTACAATC -> CATTACAATCC
GCATTGTACAT -> CATTGTACATG
GCCAAACCCAA -> CCAAACCCAAG
GCCACCTAGTG -> CCACCTAGTGA
GCCAGACACTC -> CCAGACACTCC
GCCAGACTACA -> CCAGACTACAC
GCCAGCCCGCC -> CCAGCCCGCCT
GCCAGTGATCC -> CCAGTGATCCA
GCCATACCCGC -> CCATACCCGCG
GCCCACAGTAC -> CCCACAGTACT
GCCCAGCTCTG -> CCCAGCTCTGC
GCCCAGTATCG -> CCCAGTATCGA
GCCCATAGCCG -> CCCATAGCCGG
GCCCATTCAGA -> CCCATTCAGAC
GCCCCATCATG -> CCCCATCATGA
GCCCCTTCACA -> CCCCTTCACAC
GCCCGCCTGGG -> CCCGCCTGGGA
GCCGACATGGT -> CCGACATGGTT
GCCGCACTTAC -> CCGCACTTACC
GCCGCATATAA -> CCGCATATAAG
GCCGCCAAACC -> CCGCCAAACCC
GCCGGACGGAG -> CCGGACGGAGC
GCCGGAGGGTA -> CCGGAGGGTAA
GCCGGATTTAT -> CCGGATTTATG
GCCGGCGGCAT -> CCGGCGGCATC,CCGGCGGCATT
GCCGGCTACTG -> CCGGCTACTGC
GCCGGTGGCCC -> CCGGTGGCCCA
GCCGTCATCTG -> CCGTCATCTGT
GCCGTGGGGCT -> CCGTGGGGCTG
GCCGTGTTGAC -> CCGTGTTGACG
GCCTAAATCTA -> CCTAAATCTAG
GCCTATGAGAA -> CCTATGAGAAG
GCCTCCGCCTT -> CCTCCGCCTTT
GCCTCGAACCT -> CCTCGAACCTA
GCCTGCCTCCG -> CCTGCCTCCGC
GCCTGCGCCTG -> CCTGCGCCTGC
GCCTGGGAACT -> CCTGGGAACTC
GCCTTAGAACC -> CCTTAGAACCG
GCCTTAGACGA -> CCTTAGACGAG
GCCTTCGCCTT -> CCTTCGCCTTC
GCCTTCGTTTG -> CCTTCGTTTGG
GCCTTTGAATA -> CCTTTGAATAG
GCGAATGGGCG -> CGAATGGGCGA
GCGACAACGCT -> CGACAACGCTC
GCGACAGGCCA -> CGACAGGCCAG
GCGACCCTTCA -> CGACCCTTCAG
GCGACCTCATG -> CGACCTCATGC
GCGACGTACTC -> CGACGTACTCT
GCGAGCACTTG -> CGAGCACTTGA
GCGAGGCCGTG -> CGAGGCCGTGG
GCGATAAGAGA -> CGATAAGAGAC
GCGATGGCTTA -> CGATGGCTTAC
GCGATTTCCGT -> CGATTTCCGTA
GCGCATCAGAG -> CGCATCAGAGC
GCGCATCCATA -> CGCATCCATAG
GCGCCTGCCTC -> CGCCTGCCTCC
GCGCGACAGGC -> CGCGACAGGCC
GCGCGTGGAGG -> CGCGTGGAGGG
GCGCTAACCGG -> CGCTAACCGGA
GCGGAACGCAG -> CGGAACGCAGC
GCGGATGCGGC -> CGGATGCGGCC
GCGGCACAGAC -> CGGCACAGACC
GCGGCATCAGC -> CGGCATCAGCT
GCGGCATTGTA -> CGGCATTGTAC
GCGGCCAGCCC -> CGGCCAGCCCG
GCGGCCCCTTC -> CGGCCCCTTCA
GCGGCCTTAGA -> CGGCCTTAGAA
GCGGGAGAACG -> CGGGAGAACGC
GCGGGGGCTTC -> CGGGGGCTTCT
GCGGTGTTTCT -> CGGTGTTTCTA
GCGGTTATCCC -> CGGTTATCCCG
GCGGTTCGGTC -> CGGTTCGGTCT
GCGGTTTAACA -> CGGTTTAACAG
GCGTAATCGTC -> CGTAATCGTCT
GCGTACACCTG -> CGTACACCTGT
GCGTGCCATAC -> CGTGCCATACC
GCGTGGAGGGT -> CGTGGAGGGTG
GCGTGTATATA -> CGTGTATATAC
GCGTTAGAAGG -> CGTTAGAAGGC
GCGTTTCTGTT -> CGTTTCTGTTG
GCTAAACTTGG -> CTAAACTTGGG
GCTAACCGGAG -> CTAACCGGAGC
GCTAACTGTTA -> CTAACTGTTAG
GCTACACCGCA -> CTACACCGCAC
GCTACTGCCGG -> CTACTGCCGGA
GCTAGAGCCTA -> CTAGAGCCTAT
GCTAGGCGCGA -> CTAGGCGCGAC
GCTATACCAGT -> CTATACCAGTC
GCTATTCCACT -> CTATTCCACTA
GCTCCACGAGT -> CTCCACGAGTA
GCTCCGTCGCT -> CTCCGTCGCTA
GCTCCTCTTTC -> CTCCTCTTTCA
GCTCTGCTGCG -> CTCTGCTGCGG
GCTGAACCGGG -> CTGAACCGGGA
GCTGAATGGCG -> CTGAATGGCGT
GCTGAGTGGAG -> CTGAGTGGAGT
GCTGATTAGAG -> CTGATTAGAGC
GCTGCGGAACG -> CTGCGGAACGC
GCTGCGGATGC -> CTGCGGATGCG
GCTGTATAAGT -> CTGTATAAGTG
GCTTACGGCCG -> CTTACGGCCGC
GCTTACGTGAC -> CTTACGTGACT
GCTTCTACCTC -> CTTCTACCTCA
GCTTCTTGCCC -> CTTCTTGCCCA
GCTTGAGATTC -> CTTGAGATTCA
GCTTTCCTGGG -> CTTTCCTGGGG
GCTTTTGGCCT -> CTTTTGGCCTA
GGAAAGTCGCG -> GAAAGTCGCGA
GGAACGCAGCA -> GAACGCAGCAC
GGAACTCGCGA -> GAACTCGCGAG
GGACACACTCG -> GACACACTCGC
GGACCGGGCAT -> GACCGGGCATA
GGACGACTCCC -> GACGACTCCCC
GGACGCCGGAT -> GACGCCGGATT
GGACGGAGCGC -> GACGGAGCGCT
GGACGGTTGGA -> GACGGTTGGAC
GGACTAACAAG -> GACTAACAAGC
GGACTTAGCGA -> GACTTAGCGAA
GGAGAACGCAA -> GAGAACGCAAG
GGAGATTAGCC -> GAGATTAGCCT
GGAGCAGTTTC -> GAGCAGTTTCT
GGAGCGCTAAC -> GAGCGCTAACC
GGAGGGTAACA -> GAGGGTAACAC
GGAGGGTGTCT -> GAGGGTGTCTC
GGAGTAAATCC -> GAGTAAATCCC
GGAGTACGGTG -> GAGTACGGTGC
GGAGTCAGCGG -> GAGTCAGCGGT
GGAGTGCTAGA -> GAGTGCTAGAG
GGATGCGATAA -> GATGCGATAAG
GGATGCGGCCA -> GATGCGGCCAG
GGATGGATTAT -> GATGGATTATG
GGATTATGATA -> GATTATGATAT
GGATTTATGTT -> GATTTATGTTC
GGCACAGACCC -> GCACAGACCCG
GGCACCCCCTT -> GCACCCCCTTC
GGCACCTTGGT -> GCACCTTGGTC
GGCACTACTTC -> GCACTACTTCC
GGCAGCCACCT -> GCAGCCACCTA
GGCAGTTGATA -> GCAGTTGATAT
GGCATACATGA -> GCATACATGAC
GGCATCAGCTG -> GCATCAGCTGA
GGCATTGTACA -> GCATTGTACAT
GGCCAGACACT -> GCCAGACACTC
GGCCAGACTAC -> GCCAGACTACA
GGCCAGCCCGC -> GCCAGCCCGCC
GGCCCAGCTCT -> GCCCAGCTCTG
GGCCCCTTCAC -> GCCCCTTCACA
GGCCGCCAAAC -> GCCGCCAAACC
GGCCGTGGGGC -> GCCGTGGGGCT
GGCCGTGTTGA -> GCCGTGTTGAC
GGCCTAAATCT -> GCCTAAATCTA
GGCCTGCGCCT -> GCCTGCGCCTG
GGCCTTAGAAC -> GCCTTAGAACC
GGCGACCCTTC -> GCGACCCTTCA
GGCGCGACAGG -> GCGCGACAGGC
GGCGGCATCAG -> GCGGCATCAGC
GGCGGCATTGT -> GCGGCATTGTA
GGCGGCCCCTT -> GCGGCCCCTTC
GGCGGTGTTTC -> GCGGTGTTTCT
GGCGGTTATCC -> GCGGTTATCCC
GGCGGTTTAAC -> GCGGTTTAACA
GGCGTGCCATA -> GCGTGCCATAC
GGCTACACCGC -> GCTACACCGCA
GGCTACTGCCG -> GCTACTGCCGG
GGCTCCGTCGC -> GCTCCGTCGCT
GGCTGAACCGG -> GCTGAACCGGG
GGCTTACGTGA -> GCTTACGTGAC
GGCTTCTACCT -> GCTTCTACCTC
GGGAAAGTCGC -> GGAAAGTCGCG
GGGAACTCGCG -> GGAACTCGCGA
GGGACACACTC -> GGACACACTCG
GGGAGAACGCA -> GGAGAACGCAA
GGGATGCGATA -> GGATGCGATAA
GGGATGGATTA -> GGATGGATTAT
GGGCACCCCCT -> GGCACCCCCTT
GGGCACCTTGG -> GGCACCTTGGT
GGGCACTACTT -> GGCACTACTTC
GGGCAGTTGAT -> GGCAGTTGATA
GGGCATACATG -> GGCATACATGA
GGGCCAGACAC -> GGCCAGACACT
GGGCGACCCTT -> GGCGACCCTTC
GGGCGGTGTTT -> GGCGGTGTTTC
GGGCGGTTATC -> GGCGGTTATCC
GGGCGGTTTAA -> GGCGGTTTAAC
GGGCTACACCG -> GGCTACACCGC
GGGCTGAACCG -> GGCTGAACCGG
GGGCTTCTACC -> GGCTTCTACCT
GGGGCACCTTG -> GGGCACCTTGG
GGGGCACTACT -> GGGCACTACTT
GGGGCGGTTTA -> GGGCGGTTTAA
GGGGCTGAACC -> GGGCTGAACCG
GGGGCTTCTAC -> GGGCTTCTACC
GGGGGCTTCTA -> GGGGCTTCTAC
GGGGTGCACGA -> GGGTGCACGAT
GGGGTGGAGTA -> GGGTGGAGTAA
GGGGTTATACT -> GGGTTATACTA
GGGTAACACCC -> GGTAACACCCG
GGGTGCACGAT -> GGTGCACGATA
GGGTGCGGCCT -> GGTGCGGCCTT
GGGTGGAGTAA -> GGTGGAGTAAA
GGGTGTCTCAT -> GGTGTCTCATG
GGGTTAGTTAT -> GGTTAGTTATC
GGGTTATACTA -> GGTTATACTAT
GGTAACACCCG -> GTAACACCCGA
GGTACGAACAA -> GTACGAACAAT
GGTAGACCGAT -> GTAGACCGATA
GGTATCTTGCC -> GTATCTTGCCA
GGTCGCGACAA -> GTCGCGACAAC
GGTCGCGCATC -> GTCGCGCATCA
GGTCGTGTGAA -> GTCGTGTGAAC
GGTCTACCGAC -> GTCTACCGACG
GGTCTCCCCAT -> GTCTCCCCATG
GGTGACTTTGG -> GTGACTTTGGA
GGTGCACGATA -> GTGCACGATAA
GGTGCCGGCTA -> GTGCCGGCTAC
GGTGCGGCCTT -> GTGCGGCCTTA
GGTGGAGTAAA -> GTGGAGTAAAT
GGTGGCCCAGC -> GTGGCCCAGCT
GGTGTCTCATG -> GTGTCTCATGC
GGTGTTTCTAC -> GTGTTTCTACA
GGTTAACTCGA -> GTTAACTCGAA
GGTTAGTTATC -> GTTAGTTATCG
GGTTATACTAT -> GTTATACTATT
GGTTATCCCGA -> GTTATCCCGAT
GGTTCGGTCTC -> GTTCGGTCTCC
GGTTGGACCGG -> GTTGGACCGGG
GGTTGTAAGTT -> GTTGTAAGTTG
GGTTTAACAGA -> GTTTAACAGAT
GGTTTCTAGCG -> GTTTCTAGCGG
GTAAATCCCCA -> TAAATCCCCAT
GTAAATGTATT -> TAAATGTATTA
GTAACAATCCA -> TAACAATCCAG
GTAACACCCGA -> TAACACCCGAG
GTAAGTTGTTC -> TAAGTTGTTCC
GTAATCGTCTC -> TAATCGTCTCT
GTAATGGCTCC -> TAATGGCTCCG
GTACACCTGTA -> TACACCTGTAG
GTACATGATTG -> TACATGATTGC
GTACGAACAAT -> TACGAACAATG
GTACGGTGCCG -> TACGGTGCCGG
GTACGTCTAAC -> TACGTCTAACT
GTACTCGAAAA -> TACTCGAAAAC
GTACTCTTGCC -> TACTCTTGCCG
GTACTGCGATG -> TACTGCGATGG
GTAGAAATCTC -> TAGAAATCTCG
GTAGACCGATA -> TAGACCGATAC
GTAGACTATTG -> TAGACTATTGC
GTAGCACAAGC -> TAGCACAAGCA
GTAGCATCTAC -> TAGCATCTACA
GTAGGAGATTA -> TAGGAGATTAG
GTAGGTACGAA -> TAGGTACGAAC
GTAGTCCTTGT -> TAGTCCTTGTA
GTATAACATCT -> TATAACATCTC
GTATAAGTGTG -> TATAAGTGTGC
GTATAGTCCTT -> TATAGTCCTTT
GTATATACGGT -> TATATACGGTA
GTATCACACCC -> TATCACACCCG
GTATCGAGGTT -> TATCGAGGTTG
GTATCTTGCCA -> TATCTTGCCAG
GTATTACGGGC -> TATTACGGGCA
GTATTTAGCGA -> TATTTAGCGAC
GTCAGAATTCG -> TCAGAATTCGC
GTCAGCGGTTC -> TCAGCGGTTCG
GTCATCTGTAG -> TCATCTGTAGC
GTCCCGATAGC -> TCCCGATAGCA
GTCCGACGTAA -> TCCGACGTAAA
GTCCTCCCTGA -> TCCTCCCTGAC
GTCCTTGTAGG -> TCCTTGTAGGT
GTCCTTTCAGA -> TCCTTTCAGAG
GTCGACCTTAG -> TCGACCTTAGG
GTCGAGCTATT -> TCGAGCTATTC
GTCGCGACAAC -> TCGCGACAACG
GTCGCGATTTC -> TCGCGATTTCC
GTCGCGCATCA -> TCGCGCATCAG
GTCGCTAACTG -> TCGCTAACTGT
GTCGTGTGAAC -> TCGTGTGAACG
GTCTAACTTTT -> TCTAACTTTTC
GTCTACCGACG -> TCTACCGACGA
GTCTCATGCCT -> TCTCATGCCTT
GTCTCCCCATG -> TCTCCCCATGA
GTCTCTTATAA -> TCTCTTATAAT
GTGAACGTTAT -> TGAACGTTATT
GTGAATTTTCC -> TGAATTTTCCG
GTGACTGGCAG -> TGACTGGCAGC
GTGACTTTGGA -> TGACTTTGGAC
GTGATCCATGT -> TGATCCATGTG
GTGATGCCCAG -> TGATGCCCAGT
GTGCACGATAA -> TGCACGATAAG
GTGCCATACCC -> TGCCATACCCG
GTGCCCATTCA -> TGCCCATTCAG
GTGCCGGAGGG -> TGCCGGAGGGT
GTGCCGGCTAC -> TGCCGGCTACT
GTGCGGCCTTA -> TGCGGCCTTAG
GTGCTAGAGCC -> TGCTAGAGCCT
GTGGACGGTTG -> TGGACGGTTGG
GTGGAGGGTGT -> TGGAGGGTGTC
GTGGAGTAAAT -> TGGAGTAAATC
GTGGAGTCAGC -> TGGAGTCAGCG
GTGGAGTGCTA -> TGGAGTGCTAG
GTGGCCCAGCT -> TGGCCCAGCTC
GTGGCCGTGTT -> TGGCCGTGTTG
GTGGGATGCGA -> TGGGATGCGAT
GTGGGGCTGAA -> TGGGGCTGAAC
GTGGTCGCGAC -> TGGTCGCGACA
GTGGTCGCGCA -> TGGTCGCGCAT
GTGTATATACG -> TGTATATACGG
GTGTCGAGCTA -> TGTCGAGCTAT
GTGTCTCATGC -> TGTCTCATGCC
GTGTGAACGTT -> TGTGAACGTTA
GTGTGCCCATT -> TGTGCCCATTC
GTGTGGGATGC -> TGTGGGATGCG
GTGTTGACGCA -> TGTTGACGCAA
GTGTTTCTACA -> TGTTTCTACAC
GTTAACTCGAA -> TTAACTCGAAG
GTTACATTTTA -> TTACATTTTAA
GTTAGAAGGCG -> TTAGAAGGCGG
GTTAGCTGAGT -> TTAGCTGAGTG
GTTAGTTATCG -> TTAGTTATCGT
GTTATACTATT -> TTATACTATTC
GTTATCCCGAT -> TTATCCCGATG
GTTATCGTGGT -> TTATCGTGGTC
GTTATTAGGGC -> TTATTAGGGCT
GTTCATAGCCG -> TTCATAGCCGT
GTTCCACTAGC -> TTCCACTAGCA
GTTCGGTCTCC -> TTCGGTCTCCC
GTTGACGCAAA -> TTGACGCAAAC
GTTGATATCCT -> TTGATATCCTC
GTTGATTAACT -> TTGATTAACTT
GTTGGACCGGG -> TTGGACCGGGC
GTTGGTTTCTA -> TTGGTTTCTAG
GTTGTAAGTTG -> TTGTAAGTTGT
GTTGTATCACA -> TTGTATCACAC
GTTGTTCCACT -> TTGTTCCACTA
GTTTAACAGAT -> TTTAACAGATG
GTTTACTCCTG -> TTTACTCCTGA
GTTTAGTACGT -> TTTAGTACGTC
GTTTCTACACG -> TTTCTACACGA
GTTTCTAGCGG -> TTTCTAGCGGG
GTTTCTGTATA -> TTTCTGTATAG
GTTTCTGTTGA -> TTTCTGTTGAT
GTTTGGGGTGG -> TTTGGGGTGGA
GTTTTAAGTTT -> TTTTAAGTTTA
TAAACTTGGGC -> AAACTTGGGCG
TAAATCCCCAT -> AAATCCCCATG
TAAATCTAGAC -> AAATCTAGACC
TAAATGTATTA -> AAATGTATTAC
TAACAAGCACG -> AACAAGCACGC
TAACAATCCAG -> AACAATCCAGA
TAACACCCGAG -> AACACCCGAGA
TAACAGATGTG -> AACAGATGTGC
TAACATCTCCT -> AACATCTCCTA
TAACCGGAGCA -> AACCGGAGCAG
TAACCGTCAGA -> AACCGTCAGAA
TAACGAAGAGG -> AACGAAGAGGT
TAACGCTAAAC -> AACGCTAAACT
TAACTCGAAGA -> AACTCGAAGAC
TAACTGTTAGC -> AACTGTTAGCT
TAACTTACGCA -> AACTTACGCAG
TAACTTGCTAT -> AACTTGCTATA
TAACTTTTCTA -> AACTTTTCTAT
TAAGAGACCGG -> AAGAGACCGGA
TAAGATTTCGT -> AAGATTTCGTT
TAAGCACTAAG -> AAGCACTAAGA
TAAGCGCATCC -> AAGCGCATCCA
TAAGGGCGGTG -> AAGGGCGGTGT
TAAGTGTGCCC -> AAGTGTGCCCA
TAAGTTGTTCC -> AAGTTGTTCCA
TAAGTTTAGTA -> AAGTTTAGTAC
TAATACCCGTG -> AATACCCGTGT
TAATCGTCTCT -> AATCGTCTCTT
TAATGGCTCCG -> AATGGCTCCGT
TACAAGATTGC -> ACAAGATTGCC
TACAAGGGGCA -> ACAAGGGGCAC
TACAATCCGGA -> ACAATCCGGAC
TACACCGCACA -> ACACCGCACAA
TACACCTGTAG -> ACACCTGTAGA
TACACGAAGCG -> ACACGAAGCGC
TACACTAACGA -> ACACTAACGAA
TACATCTACCT -> ACATCTACCTA
TACATGACCGC -> ACATGACCGCT
TACATGATTGC -> ACATGATTGCA
TACATTTTAAG -> ACATTTTAAGG
TACCAGTCCCG -> ACCAGTCCCGA
TACCCGCGGGG -> ACCCGCGGGGG
TACCCGTGTGG -> ACCCGTGTGGG
TACCGACGACT -> ACCGACGACTG
TACCGATGACA -> ACCGATGACAT
TACCGCGTGTA -> ACCGCGTGTAT
TACCTACCGCG -> ACCTACCGCGT
TACCTCACCAC -> ACCTCACCACT
TACGAACAATG -> ACGAACAATGT
TACGAGCTTTC -> ACGAGCTTTCC
TACGCAGAGGA -> ACGCAGAGGAC
TACGGCCGCCA -> ACGGCCGCCAA
TACGGGCACCC -> ACGGGCACCCC
TACGGTAGACC -> ACGGTAGACCG
TACGGTGCCGG -> ACGGTGCCGGC
TACGTCTAACT -> ACGTCTAACTT
TACGTGACTGG -> ACGTGACTGGC
TACTATTCTCT -> ACTATTCTCTC
TACTCCTGAGT -> ACTCCTGAGTG
TACTCGAAAAC -> ACTCGAAAACT
TACTCTTGCCG -> ACTCTTGCCGC
TACTGCCGGAC -> ACTGCCGGACG
TACTGCGATGG -> ACTGCGATGGC
TACTTCCCTTG -> ACTTCCCTTGC
TAGAAATCTCG -> AGAAATCTCGA
TAGAACCGTAA -> AGAACCGTAAT
TAGAAGCTGAT -> AGAAGCTGATT
TAGAAGGCGGC -> AGAAGGCGGCC
TAGACCGATAC -> AGACCGATACA
TAGACCTGGGA -> AGACCTGGGAT
TAGACGAGCTT -> AGACGAGCTTG
TAGACTATTGC -> AGACTATTGCG
TAGAGATACGA -> AGAGATACGAG
TAGAGCAGATA -> AGAGCAGATAC
TAGAGCCTATG -> AGAGCCTATGA
TAGCACAAGCA -> AGCACAAGCAT
TAGCACATGGG -> AGCACATGGGA
TAGCATCTACA -> AGCATCTACAT
TAGCATTACAA -> AGCATTACAAT
TAGCCGGCGGC -> AGCCGGCGGCA
TAGCCGGTGGC -> AGCCGGTGGCC
TAGCCGTCATC -> AGCCGTCATCT
TAGCCTCGAAC -> AGCCTCGAACC
TAGCGAATGGG -> AGCGAATGGGC
TAGCGACGTAC -> AGCGACGTACT
TAGCGGGAGAA -> AGCGGGAGAAC
TAGCGTTAGAA -> AGCGTTAGAAG
TAGCTGAGTGG -> AGCTGAGTGGA
TAGCTTACGGC -> AGCTTACGGCC
TAGGAGATTAG -> AGGAGATTAGC
TAGGCGCGACA -> AGGCGCGACAG
TAGGGCAGTTG -> AGGGCAGTTGA
TAGGGCTACAC -> AGGGCTACACC
TAGGGGTGCAC -> AGGGGTGCACG
TAGGTACGAAC -> AGGTACGAACA
TAGGTCGTGTG -> AGGTCGTGTGA
TAGTACGTCTA -> AGTACGTCTAA
TAGTATAACAT -> AGTATAACATC
TAGTCCTTGTA -> AGTCCTTGTAG
TAGTCCTTTCA -> AGTCCTTTCAG
TAGTGAATTTT -> AGTGAATTTTC
TAGTTATCGTG -> AGTTATCGTGG
TAGTTGTATCA -> AGTTGTATCAC
TATAACATCTC -> ATAACATCTCC
TATAAGCGCAT -> ATAAGCGCATC
TATAAGTGTGC -> ATAAGTGTGCC
TATAATACCCG -> ATAATACCCGT
TATACCAGTCC -> ATACCAGTCCC
TATACGGTAGA -> ATACGGTAGAC
TATACTATTCT -> ATACTATTCTC
TATAGTCCTTT -> ATAGTCCTTTC
TATATACGGTA -> ATATACGGTAG
TATCACACCCG -> ATCACACCCGT
TATCATCACTT -> ATCATCACTTA
TATCCCGATGG -> ATCCCGATGGG
TATCCTCGACT -> ATCCTCGACTT
TATCGAGGTTG -> ATCGAGGTTGT
TATCGTGGTCG -> ATCGTGGTCGC
TATCTTGCCAG -> ATCTTGCCAGT
TATGAATTCGA -> ATGAATTCGAT
TATGAGAAGCG -> ATGAGAAGCGT
TATGATATGAA -> ATGATATGAAT
TATGTTCATAG -> ATGTTCATAGC
TATTACGGGCA -> ATTACGGGCAC
TATTAGGGCTA -> ATTAGGGCTAC
TATTCCACTAG -> ATTCCACTAGA
TATTCTCTCCC -> ATTCTCTCCCG
TATTGCGTAAT -> ATTGCGTAATC
TATTTAGCGAC -> ATTTAGCGACG
TATTTCGTTAC -> ATTTCGTTACA
TCACACCCAGC -> CACACCCAGCA
TCACACCCGTC -> CACACCCGTCC
TCACCACTGAG -> CACCACTGAGG
TCACTTAGCCG -> CACTTAGCCGG
TCAGAATTCGC -> CAGAATTCGCC
TCAGACCGTAG -> CAGACCGTAGT
TCAGACGCTTC -> CAGACGCTTCT
TCAGAGCCGCA -> CAGAGCCGCAT
TCAGAGTCGAC -> CAGAGTCGACC
TCAGATCTCTG -> CAGATCTCTGT
TCAGCAAGGTA -> CAGCAAGGTAT
TCAGCACAACT -> CAGCACAACTC
TCAGCGGTTCG -> CAGCGGTTCGG
TCAGCTGAATG -> CAGCTGAATGG
TCATAGCCGTC -> CATAGCCGTCA
TCATATTTCGT -> CATATTTCGTT
TCATCACTTAG -> CATCACTTAGC
TCATCTGTAGC -> CATCTGTAGCA
TCATGATCATA -> CATGATCATAT
TCATGCCTTAG -> CATGCCTTAGA
TCATGCGGCAC -> CATGCGGCACA
TCCACGAGTAT -> CCACGAGTATT
TCCACTAGAAG -> CCACTAGAAGC
TCCACTAGCAC -> CCACTAGCACA
TCCAGATTTCT -> CCAGATTTCTG
TCCAGCCGACA -> CCAGCCGACAT
TCCATAGCTTA -> CCATAGCTTAC
TCCATGTGGTC -> CCATGTGGTCG
TCCCCATGACT -> CCCCATGACTT
TCCCCATGGAC -> CCCCATGGACT
TCCCCGCTGTA -> CCCCGCTGTAT
TCCCGATAGCA -> CCCGATAGCAT
TCCCGATGGGT -> CCCGATGGGTT
TCCCGTGGACG -> CCCGTGGACGG
TCCCTGACTGG -> CCCTGACTGGC
TCCCTTGCGTA -> CCCTTGCGTAC
TCCGACGTAAA -> CCGACGTAAAT
TCCGCCTTTGA -> CCGCCTTTGAA
TCCGGACTAAC -> CCGGACTAACA
TCCGGGGCGGT -> CCGGGGCGGTT
TCCGTAACAAT -> CCGTAACAATC
TCCGTACTCGA -> CCGTACTCGAA
TCCGTCGCTAA -> CCGTCGCTAAC
TCCTAGGGGTG -> CCTAGGGGTGC
TCCTCCCTGAC -> CCTCCCTGACT
TCCTCGACTTT -> CCTCGACTTTA
TCCTCTTTCAG -> CCTCTTTCAGA
TCCTGAGTGGA -> CCTGAGTGGAG
TCCTGGGGCAC -> CCTGGGGCACC
TCCTTGTAGGT -> CCTTGTAGGTA
TCCTTTCAGAG -> CCTTTCAGAGT
TCGAAAACTCG -> CGAAAACTCGT
TCGAACCTAAC -> CGAACCTAACG
TCGAAGACGCT -> CGAAGACGCTT
TCGACATAGCG -> CGACATAGCGT
TCGACCTTAGG -> CGACCTTAGGG
TCGACTTTAGG -> CGACTTTAGGT
TCGAGCTATTC -> CGAGCTATTCC
TCGAGGTTGTA -> CGAGGTTGTAA
TCGATGCACAG -> CGATGCACAGC
TCGATGTGATG -> CGATGTGATGC
TCGCAGGGTGC -> CGCAGGGTGCG
TCGCCTTCGCC -> CGCCTTCGCCT
TCGCCTTCGTT -> CGCCTTCGTTT
TCGCGACAACG -> CGCGACAACGC
TCGCGAGGCCG -> CGCGAGGCCGT
TCGCGATTTCC -> CGCGATTTCCG
TCGCGCATCAG -> CGCGCATCAGA
TCGCTAACTGT -> CGCTAACTGTT
TCGCTCCACGA -> CGCTCCACGAG
TCGGAGTACGG -> CGGAGTACGGT
TCGGTCTCCCC -> CGGTCTCCCCA
TCGTAGCACAA -> CGTAGCACAAG
TCGTCTCTTAT -> CGTCTCTTATA
TCGTGGTCGCG -> CGTGGTCGCGC
TCGTGTGAACG -> CGTGTGAACGT
TCGTTACATTT -> CGTTACATTTT
TCGTTTGGGGT -> CGTTTGGGGTG
TCGTTTTAAGT -> CGTTTTAAGTT
TCTAACTTTTC -> CTAACTTTTCT
TCTACACGAAG -> CTACACGAAGC
TCTACATCTAC -> CTACATCTACC
TCTACCGACGA -> CTACCGACGAC
TCTACCTACCG -> CTACCTACCGC
TCTACCTCACC -> CTACCTCACCA
TCTAGACCTGG -> CTAGACCTGGG
TCTAGCGGGAG -> CTAGCGGGAGA
TCTATCATCAC -> CTATCATCACT
TCTCATGCCTT -> CTCATGCCTTA
TCTCCCCATGA -> CTCCCCATGAC
TCTCCCGTGGA -> CTCCCGTGGAC
TCTCCTAGGGG -> CTCCTAGGGGT
TCTCGATGCAC -> CTCGATGCACA
TCTCTCCCGTG -> CTCTCCCGTGG
TCTCTGTTTAC -> CTCTGTTTACT
TCTCTTATAAT -> CTCTTATAATA
TCTGCGACCTC -> CTGCGACCTCA
TCTGCTGCGGA -> CTGCTGCGGAT
TCTGTAGCATC -> CTGTAGCATCT
TCTGTATAGTC -> CTGTATAGTCC
TCTGTCCGACG -> CTGTCCGACGT
TCTGTTGATTA -> CTGTTGATTAA
TCTGTTTACTC -> CTGTTTACTCC
TCTTATAATAC -> CTTATAATACC
TCTTGCCAGTG -> CTTGCCAGTGA
TCTTGCCCACA -> CTTGCCCACAG
TCTTGCCGCAC -> CTTGCCGCACT
TCTTTCAGACC -> CTTTCAGACCG
TGAACCGGGAA -> GAACCGGGAAA
TGAACGTTATT -> GAACGTTATTA
TGAACTCGGAG -> GAACTCGGAGT
TGAATAGAGAT -> GAATAGAGATA
TGAATGGCGTG -> GAATGGCGTGC
TGAATTCGATG -> GAATTCGATGT
TGAATTTTCCG -> GAATTTTCCGG
TGACACCATAA -> GACACCATAAC
TGACATAGTAT -> GACATAGTATA
TGACCGCTAGG -> GACCGCTAGGC
TGACGCAAACG -> GACGCAAACGG
TGACTGGCAGC -> GACTGGCAGCC
TGACTGGCCTG -> GACTGGCCTGC
TGACTTTGGAC -> GACTTTGGACG
TGACTTTTTAA -> GACTTTTTAAC
TGAGAAGCGTT -> GAGAAGCGTTT
TGAGATTCAGC -> GAGATTCAGCA
TGAGGGGTTAT -> GAGGGGTTATA
TGAGTGGAGTC -> GAGTGGAGTCA
TGAGTGGAGTG -> GAGTGGAGTGC
TGATATCCTCG -> GATATCCTCGA
TGATATGAATT -> GATATGAATTC
TGATCATATTT -> GATCATATTTC
TGATCCATGTG -> GATCCATGTGG
TGATGCCCAGT -> GATGCCCAGTA
TGATTAACTTA -> GATTAACTTAC
TGATTAGAGCA -> GATTAGAGCAG
TGATTGCAGCT -> GATTGCAGCTG
TGCAATTCTGT -> GCAATTCTGTC
TGCACAGCCGG -> GCACAGCCGGC
TGCACGATAAG -> GCACGATAAGC
TGCAGCTGCGG -> GCAGCTGCGGA
TGCCAGTGATC -> GCCAGTGATCC
TGCCATACCCG -> GCCATACCCGC
TGCCCACAGTA -> GCCCACAGTAC
TGCCCAGTATC -> GCCCAGTATCG
TGCCCATAGCC -> GCCCATAGCCG
TGCCCATTCAG -> GCCCATTCAGA
TGCCGCACTTA -> GCCGCACTTAC
TGCCGGACGGA -> GCCGGACGGAG
TGCCGGAGGGT -> GCCGGAGGGTA
TGCCGGCTACT -> GCCGGCTACTG
TGCCTCCGCCT -> GCCTCCGCCTT
TGCCTTAGACG -> GCCTTAGACGA
TGCGACCTCAT -> GCGACCTCATG
TGCGATAAGAG -> GCGATAAGAGA
TGCGATGGCTT -> GCGATGGCTTA
TGCGCCTGCCT -> GCGCCTGCCTC
TGCGGAACGCA -> GCGGAACGCAG
TGCGGATGCGG -> GCGGATGCGGC
TGCGGCACAGA -> GCGGCACAGAC
TGCGGCCAGCC -> GCGGCCAGCCC
TGCGGCCTTAG -> GCGGCCTTAGA
TGCGTAATCGT -> GCGTAATCGTC
TGCGTACACCT -> GCGTACACCTG
TGCTAGAGCCT -> GCTAGAGCCTA
TGCTATACCAG -> GCTATACCAGT
TGCTGCGGATG -> GCTGCGGATGC
TGGACCGGGCA -> GGACCGGGCAT
TGGACGACTCC -> GGACGACTCCC
TGGACGGTTGG -> GGACGGTTGGA
TGGACTTAGCG -> GGACTTAGCGA
TGGAGGGTGTC -> GGAGGGTGTCT
TGGAGTAAATC -> GGAGTAAATCC
TGGAGTCAGCG -> GGAGTCAGCGG
TGGAGTGCTAG -> GGAGTGCTAGA
TGGATTATGAT -> GGATTATGATA
TGGCAGCCACC -> GGCAGCCACCT
TGGCCCAGCTC -> GGCCCAGCTCT
TGGCCGTGTTG -> GGCCGTGTTGA
TGGCCTAAATC -> GGCCTAAATCT
TGGCCTGCGCC -> GGCCTGCGCCT
TGGCGTGCCAT -> GGCGTGCCATA
TGGCTCCGTCG -> GGCTCCGTCGC
TGGCTTACGTG -> GGCTTACGTGA
TGGGAACTCGC -> GGGAACTCGCG
TGGGACACACT -> GGGACACACTC
TGGGATGCGAT -> GGGATGCGATA
TGGGATGGATT -> GGGATGGATTA
TGGGCGACCCT -> GGGCGACCCTT
TGGGCGGTTAT -> GGGCGGTTATC
TGGGGCACCTT -> GGGGCACCTTG
TGGGGCTGAAC -> GGGGCTGAACC
TGGGGTGGAGT -> GGGGTGGAGTA
TGGGTTAGTTA -> GGGTTAGTTAT
TGGTCGCGACA -> GGTCGCGACAA
TGGTCGCGCAT -> GGTCGCGCATC
TGGTCTACCGA -> GGTCTACCGAC
TGGTTAACTCG -> GGTTAACTCGA
TGGTTTCTAGC -> GGTTTCTAGCG
TGTAAGTTGTT -> GTAAGTTGTTC
TGTACATGATT -> GTACATGATTG
TGTAGAAATCT -> GTAGAAATCTC
TGTAGACTATT -> GTAGACTATTG
TGTAGCATCTA -> GTAGCATCTAC
TGTAGGAGATT -> GTAGGAGATTA
TGTAGGTACGA -> GTAGGTACGAA
TGTATAAGTGT -> GTATAAGTGTG
TGTATAGTCCT -> GTATAGTCCTT
TGTATATACGG -> GTATATACGGT
TGTATCACACC -> GTATCACACCC
TGTATTACGGG -> GTATTACGGGC
TGTCCGACGTA -> GTCCGACGTAA
TGTCGAGCTAT -> GTCGAGCTATT
TGTCTCATGCC -> GTCTCATGCCT
TGTGAACGTTA -> GTGAACGTTAT
TGTGATGCCCA -> GTGATGCCCAG
TGTGCCCATTC -> GTGCCCATTCA
TGTGCCGGAGG -> GTGCCGGAGGG
TGTGGGATGCG -> GTGGGATGCGA
TGTGGTCGCGA -> GTGGTCGCGAC
TGTTAGCTGAG -> GTTAGCTGAGT
TGTTCATAGCC -> GTTCATAGCCG
TGTTCCACTAG -> GTTCCACTAGC
TGTTGACGCAA -> GTTGACGCAAA
TGTTGATTAAC -> GTTGATTAACT
TGTTGGTTTCT -> GTTGGTTTCTA
TGTTTACTCCT -> GTTTACTCCTG
TGTTTCTACAC -> GTTTCTACACG
TTAACAGATGT -> TAACAGATGTG
TTAACTCGAAG -> TAACTCGAAGA
TTAACTTACGC -> TAACTTACGCA
TTAACTTGCTA -> TAACTTGCTAT
TTAAGGGCGGT -> TAAGGGCGGTG
TTAAGTTTAGT -> TAAGTTTAGTA
TTACAATCCGG -> TACAATCCGGA
TTACATTTTAA -> TACATTTTAAG
TTACCGATGAC -> TACCGATGACA
TTACGCAGAGG -> TACGCAGAGGA
TTACGGCCGCC -> TACGGCCGCCA
TTACGGGCACC -> TACGGGCACCC
TTACGTGACTG -> TACGTGACTGG
TTACTCCTGAG -> TACTCCTGAGT
TTAGAACCGTA -> TAGAACCGTAA
TTAGAAGGCGG -> TAGAAGGCGGC
TTAGACGAGCT -> TAGACGAGCTT
TTAGAGCAGAT -> TAGAGCAGATA
TTAGCCGGTGG -> TAGCCGGTGGC
TTAGCCTCGAA -> TAGCCTCGAAC
TTAGCGAATGG -> TAGCGAATGGG
TTAGCGACGTA -> TAGCGACGTAC
TTAGCTGAGTG -> TAGCTGAGTGG
TTAGGGCAGTT -> TAGGGCAGTTG
TTAGGGCTACA -> TAGGGCTACAC
TTAGGTCGTGT -> TAGGTCGTGTG
TTAGTACGTCT -> TAGTACGTCTA
TTAGTTATCGT -> TAGTTATCGTG
TTATAATACCC -> TATAATACCCG
TTATACTATTC -> TATACTATTCT
TTATCCCGATG -> TATCCCGATGG
TTATCGTGGTC -> TATCGTGGTCG
TTATGATATGA -> TATGATATGAA
TTATGTTCATA -> TATGTTCATAG
TTATTAGGGCT -> TATTAGGGCTA
TTCACACCCAG -> TCACACCCAGC
TTCAGACCGTA -> TCAGACCGTAG
TTCAGACGCTT -> TCAGACGCTTC
TTCAGAGTCGA -> TCAGAGTCGAC
TTCAGATCTCT -> TCAGATCTCTG
TTCAGCACAAC -> TCAGCACAACT
TTCATAGCCGT -> TCATAGCCGTC
TTCCACTAGAA -> TCCACTAGAAG
TTCCACTAGCA -> TCCACTAGCAC
TTCCCTTGCGT -> TCCCTTGCGTA
TTCCGGGGCGG -> TCCGGGGCGGT
TTCCGTACTCG -> TCCGTACTCGA
TTCCTGGGGCA -> TCCTGGGGCAC
TTCGATGTGAT -> TCGATGTGATG
TTCGCAGGGTG -> TCGCAGGGTGC
TTCGCCTTCGC -> TCGCCTTCGCC
TTCGCCTTCGT -> TCGCCTTCGTT
TTCGGTCTCCC -> TCGGTCTCCCC
TTCGTTACATT -> TCGTTACATTT
TTCGTTTGGGG -> TCGTTTGGGGT
TTCGTTTTAAG -> TCGTTTTAAGT
TTCTACACGAA -> TCTACACGAAG
TTCTACCTCAC -> TCTACCTCACC
TTCTAGCGGGA -> TCTAGCGGGAG
TTCTATCATCA -> TCTATCATCAC
TTCTCTCCCGT -> TCTCTCCCGTG
TTCTGCGACCT -> TCTGCGACCTC
TTCTGTATAGT -> TCTGTATAGTC
TTCTGTCCGAC -> TCTGTCCGACG
TTCTGTTGATT -> TCTGTTGATTA
TTCTTGCCCAC -> TCTTGCCCACA
TTGAACTCGGA -> TGAACTCGGAG
TTGAATAGAGA -> TGAATAGAGAT
TTGACGCAAAC -> TGACGCAAACG
TTGAGATTCAG -> TGAGATTCAGC
TTGATATCCTC -> TGATATCCTCG
TTGATTAACTT -> TGATTAACTTA
TTGCAATTCTG -> TGCAATTCTGT
TTGCAGCTGCG -> TGCAGCTGCGG
TTGCCAGTGAT -> TGCCAGTGATC
TTGCCCACAGT -> TGCCCACAGTA
TTGCCCATAGC -> TGCCCATAGCC
TTGCCGCACTT -> TGCCGCACTTA
TTGCGTAATCG -> TGCGTAATCGT
TTGCGTACACC -> TGCGTACACCT
TTGCTATACCA -> TGCTATACCAG
TTGGACCGGGC -> TGGACCGGGCA
TTGGACGACTC -> TGGACGACTCC
TTGGCCTAAAT -> TGGCCTAAATC
TTGGGCGGTTA -> TGGGCGGTTAT
TTGGGGTGGAG -> TGGGGTGGAGT
TTGGTCTACCG -> TGGTCTACCGA
TTGGTTTCTAG -> TGGTTTCTAGC
TTGTAAGTTGT -> TGTAAGTTGTT
TTGTACATGAT -> TGTACATGATT
TTGTAGGTACG -> TGTAGGTACGA
TTGTATCACAC -> TGTATCACACC
TTGTTCCACTA -> TGTTCCACTAG
TTGTTGGTTTC -> TGTTGGTTTCT
TTTAACAGATG -> TTAACAGATGT
TTTAACTTGCT -> TTAACTTGCTA
TTTAAGGGCGG -> TTAAGGGCGGT
TTTAAGTTTAG -> TTAAGTTTAGT
TTTACTCCTGA -> TTACTCCTGAG
TTTAGCGACGT -> TTAGCGACGTA
TTTAGGTCGTG -> TTAGGTCGTGT
TTTAGTACGTC -> TTAGTACGTCT
TTTATGTTCAT -> TTATGTTCATA
TTTCAGACCGT -> TTCAGACCGTA
TTTCAGAGTCG -> TTCAGAGTCGA
TTTCCGGGGCG -> TTCCGGGGCGG
TTTCCGTACTC -> TTCCGTACTCG
TTTCCTGGGGC -> TTCCTGGGGCA
TTTCGTTACAT -> TTCGTTACATT
TTTCGTTTTAA -> TTCGTTTTAAG
TTTCTACACGA -> TTCTACACGAA
TTTCTAGCGGG -> TTCTAGCGGGA
TTTCTATCATC -> TTCTATCATCA
TTTCTGCGACC -> TTCTGCGACCT
TTTCTGTATAG -> TTCTGTATAGT
TTTCTGTTGAT -> TTCTGTTGATT
TTTGAATAGAG -> TTGAATAGAGA
TTTGGACGACT -> TTGGACGACTC
TTTGGCCTAAA -> TTGGCCTAAAT
TTTGGGGTGGA -> TTGGGGTGGAG
TTTGTTGGTTT -> TTGTTGGTTTC
TTTTAACTTGC -> TTTAACTTGCT
TTTTAAGGGCG -> TTTAAGGGCGG
TTTTAAGTTTA -> TTTAAGTTTAG
TTTTCCGGGGC -> TTTCCGGGGCG
TTTTCTATCAT -> TTTCTATCATC
TTTTGGCCTAA -> TTTGGCCTAAA
TTTTTAACTTG -> TTTTAACTTGC
